width 20
height 20
.............@......
......@..........@@.
....................
....................
@..@......@.@.@@....
...@...@.........@..
..............@.....
...@........@.......
.......@..........@.
.....@...........@..
.@..................
........@.......@...
..@..@...@...@...@..
....................
.......@............
..........@.........
..............@.....
..........@.........
...@...........@...@
@@@@.....@........@@
16
5 5 0
6 8 0
11 4 0
4 1 0
11 15 0
0 6 0
14 5 1
7 2 1
10 5 1
15 1 1
3 16 1
12 11 2
8 17 2
6 10 2
17 10 2
15 16 2

16 13 0
1 1 0
11 3 0
11 15 0
0 0 0
8 14 0
1 6 1
18 4 1
8 18 1
6 13 1
17 6 1
12 19 2
13 2 2
7 11 2
5 15 2
0 2 2
