width 20
height 20
.................@@@
..................@@
..@.....@..........@
....@......@...@@@@@
..........@....@@@@@
.@...............@@@
..@......@..@.@.....
...@...@........@...
..............@.....
....................
....................
.....@.........@....
.........@....@.....
................@.@.
.......@............
.....@.......@@.@..@
.@.........@..@.....
.......@.@@......@@.
.........@@..@...@@@
........@@@......@@@
16
16 11 0
11 7 0
18 16 0
13 13 0
4 14 0
12 18 0
7 1 1
4 8 1
4 9 1
6 4 1
10 10 1
14 2 2
5 2 2
11 2 2
0 12 2
17 15 2

13 0 0
6 6 0
7 12 0
0 0 0
4 0 0
8 14 0
5 3 1
19 13 1
4 14 1
6 5 1
11 19 1
10 2 2
17 2 2
15 8 2
15 2 2
8 18 2
