width 20
height 20
@@..................
@@.........@..@..@..
@@..................
...........@....@...
..@...............@.
...@.............@..
.........@..@.......
.........@.....@....
....................
..@..........@@.....
...............@....
...@...@.@..........
..@.@...............
.....@......@.......
..................@.
............@.......
..@.@..@.....@......
....................
...@......@@........
.@@@......@@........
16
14 6 0
16 9 0
13 6 0
18 10 0
17 11 0
5 2 0
11 9 1
10 4 1
5 8 1
0 16 1
12 3 1
4 2 2
6 3 2
0 19 2
6 15 2
9 4 2

0 18 0
2 18 0
1 18 0
0 19 0
11 16 0
16 11 0
10 12 1
12 5 1
0 17 1
2 14 1
17 17 1
15 17 2
6 3 2
2 5 2
14 0 2
7 6 2
