width 20
height 20
....................
....................
......@...@..@......
..@..............@..
...@...@..@...@.....
@.......@...........
...........@........
........@...........
..@...@........@....
.@.@......@.....@...
............@.......
......@..@..........
..............@.....
...............@....
.......@............
......@.@.@......@..
....................
....................
....................
...............@....
16
7 9 0
9 15 0
3 12 0
7 6 0
17 5 0
10 13 0
13 1 1
17 17 1
6 19 1
9 4 1
13 10 1
9 13 2
15 11 2
19 11 2
0 8 2
2 6 2

4 7 0
15 3 0
17 4 0
5 11 0
15 9 0
0 1 0
12 0 1
6 9 1
19 7 1
16 16 1
5 19 1
12 1 2
14 10 2
15 17 2
4 2 2
15 18 2
