width 20
height 20
.....@..............
................@...
....................
............@..@....
..@..........@......
...@@...............
........@.........@@
.......@..........@@
...........@......@.
...@.@.@..@.........
..@.@............@..
.......@......@.....
......@..@.@...@....
@..@................
@.....@...........@.
@......@............
...@.......@........
........@.@.....@...
.....@........@.....
@...................
16
7 10 0
0 9 0
2 2 0
6 17 0
5 11 0
6 19 0
17 17 1
9 1 1
0 1 1
6 3 1
10 6 1
7 5 2
7 2 2
7 6 2
17 9 2
6 13 2

14 2 0
10 5 0
4 0 0
15 0 0
2 13 0
1 17 0
2 0 1
13 8 1
0 10 1
15 17 1
10 6 1
4 11 2
17 12 2
19 19 2
18 9 2
19 1 2
