width 20
height 20
..@................@
........@....@.....@
.@..@..........@....
.@........@.........
.....@.......@......
...@...........@....
..........@.........
...............@....
....................
..@...@.............
...............@....
....................
@....@....@.@.......
@......@.@..........
....................
....@.......@.@.....
....................
....................
....@...............
.....@.....@@.......
16
18 17 0
13 10 0
18 14 0
0 10 0
13 3 0
11 10 0
2 4 1
5 7 1
4 9 1
14 17 1
16 17 1
1 4 2
8 10 2
15 15 2
0 14 2
3 4 2

13 10 0
0 2 0
4 4 0
16 2 0
0 8 0
9 3 0
5 1 1
7 7 1
18 18 1
0 14 1
16 0 1
18 17 2
17 19 2
4 16 2
1 10 2
4 0 2
