width 20
height 20
......@....@........
......@..........@..
......@......@......
..........@.........
.....@.@.@..........
...........@........
........@...........
......@.............
..........@...@.....
....@..@@...........
....................
..@...@..@.@........
......@.......@.....
..@...@......@.....@
..@.@...........@..@
..............@....@
......@......@....@@
....@....@........@@
@..................@
@.................@@
16
10 10 0
12 3 0
1 16 0
8 7 0
4 1 0
4 7 0
16 17 1
11 8 1
11 15 1
8 11 1
12 1 1
17 19 2
2 9 2
5 19 2
5 16 2
19 8 2

7 10 0
2 19 0
16 7 0
13 5 0
3 0 0
2 10 0
0 7 1
15 5 1
3 1 1
9 19 1
17 5 1
16 13 2
4 13 2
19 0 2
4 18 2
16 15 2
