width 20
height 20
....................
............@.@.@...
.........@..........
...@.............@..
.............@......
......@.............
...........@@.@...@.
..@.........@.......
......@.@.@.........
....................
....................
...@................
.................@..
......@.............
...@........@.......
..........@.........
@.....@.@.....@.@...
..................@.
............@..@....
....................
16
5 14 0
12 0 0
6 0 0
14 10 0
1 6 0
16 7 0
5 12 1
6 10 1
6 12 1
14 13 1
2 11 1
4 7 2
19 9 2
15 15 2
19 16 2
9 17 2

15 7 0
0 4 0
4 14 0
0 2 0
17 19 0
0 19 0
16 0 1
3 19 1
2 16 1
15 14 1
10 7 1
10 1 2
17 13 2
6 0 2
2 2 2
7 10 2
