width 20
height 20
....................
........@...........
.........@.@.@......
...@................
@...........@.......
@@......@.@..@...@..
@@@..@..............
.......@............
....@...@..@....@...
...@.@.......@......
................@...
.@..@.@......@......
.......@............
...........@.@......
.@........@.........
....................
.........@.....@....
@...@@..@@..........
@@.@@@@@@@.@......@.
@@@@@@@@@@...@......
16
3 14 0
6 14 0
8 16 0
5 12 0
14 1 0
5 10 0
3 16 1
4 12 1
18 7 1
11 16 1
18 13 1
16 4 2
2 11 2
19 15 2
3 5 2
1 9 2

2 17 0
17 16 0
8 10 0
4 9 0
2 18 0
5 11 0
14 6 1
0 12 1
5 3 1
1 1 1
0 0 1
7 0 2
1 10 2
15 4 2
19 11 2
15 15 2
