width 20
height 20
...................@
............@......@
@...................
@@..@....@..@.......
@@......@...........
@...........@.......
@@........@..@..@...
....................
...............@....
..@......@...@..@.@.
....@..@............
...@.......@.@......
....................
@..........@..@.....
.......@........@...
....................
...@...@............
@.........@......@..
....................
....................
16
15 1 0
2 12 0
6 11 0
13 4 0
18 12 0
5 11 0
2 15 1
6 4 1
0 19 1
7 2 1
8 12 1
3 5 2
7 19 2
0 15 2
1 17 2
17 8 2

5 13 0
11 6 0
7 7 0
2 19 0
2 2 0
14 5 0
16 19 1
6 13 1
1 14 1
9 11 1
0 9 1
2 10 2
14 0 2
1 16 2
14 15 2
15 3 2
