width 20
height 20
....@...............
....................
.@..................
.....@..@.....@...@.
.@..............@...
...@.@...@.@........
.............@..@...
..............@.....
.....@..............
....................
...@.............@..
..@.................
......@...@......@..
.@@....@...@........
......@.....@.......
.....@..............
............@.......
....................
....................
.......@...@........
16
8 7 0
7 9 0
0 4 0
12 8 0
13 9 0
9 16 0
11 0 1
7 6 1
19 9 1
9 0 1
7 3 1
4 5 2
7 0 2
3 13 2
4 8 2
4 16 2

2 4 0
16 2 0
18 19 0
1 18 0
3 3 0
12 4 0
1 19 1
19 17 1
0 17 1
15 18 1
19 6 1
5 6 2
13 0 2
7 15 2
8 9 2
4 17 2
