width 20
height 20
@@@@..@..@..........
@@@@................
@@@...........@.@...
@@...@.............@
.@...........@......
.....@...........@..
................@...
....................
..@....@@.........@.
.@......@@.....@.@..
......@.............
....@...............
.....@......@.......
..@......@.....@....
............@.......
.....@...........@..
......@.@...........
..........@.........
....@@@.............
.....@..............
16
12 3 0
16 8 0
1 14 0
1 10 0
19 11 0
15 14 0
7 11 1
2 5 1
6 9 1
11 8 1
14 12 1
17 16 2
6 17 2
12 5 2
12 10 2
10 19 2

9 2 0
19 18 0
19 16 0
2 19 0
6 5 0
8 1 0
6 3 1
4 6 1
9 6 1
0 19 1
5 4 1
9 11 2
19 5 2
0 17 2
14 10 2
2 4 2
