width 20
height 20
@@..................
@@..................
@.....@....@........
........@....@..@...
............@.......
..@.@........@......
..........@...@.....
....................
..@....@..........@@
.@................@@
............@......@
....@..........@@@..
@..@....@.@.....@...
@........@.....@....
.......@............
....................
.............@......
......@.............
....@...............
....................
16
10 17 0
19 18 0
2 0 0
18 10 0
0 16 0
16 9 0
11 7 1
10 7 1
1 19 1
15 10 1
5 3 1
15 16 2
8 15 2
11 6 2
7 13 2
3 8 2

14 2 0
13 13 0
15 10 0
1 18 0
15 5 0
19 15 0
14 10 1
10 8 1
3 9 1
16 10 1
0 5 1
18 18 2
8 15 2
11 6 2
7 13 2
4 8 2
