width 20
height 20
...........@@@....@@
......@....@........
.@...@.....@..@@....
.........@.@....@...
....@...............
....................
........@.@.....@...
...@.....@..@.......
.....@........@@....
....................
..........@..@.@....
..@....@............
.........@..@..@...@
.@...@..@..........@
....@.....@........@
@@@..@..............
@@@............@....
@@@...@...@..@......
@@..................
@..................@
16
8 18 0
14 13 0
0 5 0
4 0 0
3 4 0
2 6 0
1 19 1
14 17 1
16 12 1
18 15 1
9 18 1
16 19 2
10 11 2
3 18 2
6 14 2
14 14 2

8 18 0
2 2 0
0 5 0
7 18 0
15 9 0
9 4 0
14 3 1
5 11 1
2 12 1
2 0 1
0 0 1
2 4 2
11 5 2
14 9 2
5 4 2
12 15 2
