width 20
height 20
............@@......
........@...........
.....@..@...........
...@................
.........@....@.....
...@..@.....@.......
....................
.....@..........@...
....@.@.............
.........@.........@
.@.@........@......@
......@...@@...@....
....@.....@.......@@
........@....@......
.........@.@....@...
...@................
.................@@@
..@.......@.@......@
..............@....@
........@@@........@
16
10 1 0
0 10 0
17 4 0
19 11 0
0 11 0
7 4 0
7 19 1
7 9 1
9 10 1
17 18 1
7 17 1
5 14 2
6 16 2
15 10 2
17 10 2
1 19 2

11 17 0
1 11 0
13 6 0
8 10 0
18 5 0
2 19 0
8 15 1
9 5 1
9 11 1
1 4 1
12 6 1
18 0 2
6 16 2
0 0 2
7 1 2
7 13 2
