width 20
height 20
................@@..
........@...........
.....@.......@.@....
...@..@.............
.........@.@...@....
.....@..............
.......@..........@.
..@......@......@...
............@.......
......@.......@.....
....@...@.@....@....
............@...@...
........@...........
...........@@.......
....................
.........@..........
....@...............
..........@.........
....................
....................
16
18 2 0
7 2 0
9 0 0
6 19 0
1 16 0
16 14 0
12 9 1
3 4 1
0 0 1
2 15 1
0 19 1
2 17 2
10 16 2
14 18 2
12 7 2
2 18 2

2 15 0
7 5 0
3 12 0
8 0 0
5 13 0
9 10 0
0 19 1
18 17 1
12 3 1
18 1 1
2 18 1
11 5 2
0 1 2
10 6 2
12 7 2
3 18 2
