width 20
height 20
@@..................
........@.....@@....
..............@@....
..@....@..@...@@....
......@...........@.
....@......@@@@.....
...@.....@...@..@...
......@.............
...........@.......@
............@....@@@
...........@.......@
....@.....@.........
.................@..
..............@.....
..........@.........
.......@............
.....@..@.@....@....
....................
..@..............@..
....................
16
12 6 0
17 0 0
9 7 0
19 7 0
10 7 0
18 19 0
2 4 1
16 4 1
17 1 1
13 18 1
7 6 1
16 19 2
11 7 2
17 15 2
1 8 2
3 13 2

19 18 0
16 3 0
7 4 0
6 19 0
15 18 0
5 3 0
17 13 1
16 4 1
0 9 1
13 17 1
10 8 1
3 1 2
1 13 2
6 2 2
5 14 2
17 17 2
