width 20
height 20
@@@@..........@@@@@.
@@@@................
@@@@........@.......
@.....@.......@.....
@..@................
@..............@....
........@@..........
......@.............
...............@.@..
.......@..@..@......
..@..@..............
..........@...@....@
..@...@.............
.............@......
..@..@......@@......
.........@....@....@
...@.@.............@
...................@
..................@@
@...........@@@....@
16
0 6 0
10 10 0
14 6 0
3 11 0
1 18 0
9 17 0
4 8 1
10 0 1
5 0 1
8 17 1
17 16 1
2 6 2
13 0 2
19 14 2
16 9 2
3 7 2

1 6 0
15 16 0
14 6 0
4 11 0
1 14 0
13 17 0
15 11 1
3 19 1
5 2 1
11 9 1
4 3 1
2 6 2
9 18 2
4 12 2
2 18 2
17 14 2
