width 20
height 20
....@...............
.....@.......@......
...............@....
.......@...@........
.....@..............
@.........@..@..@...
@@.....@...@...@....
@@@..@..............
......@.............
............@..@....
...................@
......@........@....
....................
...@....@....@.@....
........@........@..
...@....@...........
.............@......
....@.@.@..@........
@.@.............@...
.........@..........
16
18 18 0
14 17 0
9 8 0
14 6 0
3 7 0
16 8 0
9 14 1
6 5 1
7 13 1
17 10 1
9 1 1
19 18 2
4 6 2
4 3 2
12 12 2
5 18 2

9 10 0
4 8 0
13 2 0
10 13 0
5 16 0
0 17 0
3 2 1
2 4 1
19 5 1
7 5 1
19 19 1
7 11 2
4 6 2
3 1 2
0 0 2
17 4 2
