width 20
height 20
@......@@...........
@...................
.........@..........
........@...........
...........@.@...@..
..@....@............
.....@.......@......
..........@....@....
......@.@.......@...
@....@.@............
@...........@.......
.........@........@.
....@..........@....
...@....@...........
.@.......@..........
.@...............@..
...@........@...@...
....................
...@....@.@.@.......
....................
16
0 3 0
19 13 0
15 0 0
5 1 0
14 17 0
4 19 0
9 7 1
18 4 1
18 7 1
15 13 1
6 6 1
3 15 2
10 9 2
1 6 2
13 16 2
2 9 2

13 19 0
5 2 0
0 17 0
9 13 0
2 15 0
2 3 0
17 19 1
19 4 1
15 0 1
13 13 1
18 19 1
10 1 2
0 19 2
19 7 2
9 17 2
19 17 2
