width 20
height 20
@.........@@....@.@@
@.......@..........@
.....@.@....@......@
.............@...@.@
....................
......@..@.@.@......
.@..@...........@...
.........@..........
...@..@.............
.............@..@...
.....@........@.....
.................@..
.........@..........
.....@..........@...
.........@.....@....
.@......@.....@.....
...@.......@........
.@...@.@............
................@...
....................
16
12 1 0
16 10 0
8 12 0
8 19 0
17 7 0
4 9 0
10 10 1
19 11 1
13 2 1
8 0 1
10 17 1
2 7 2
2 19 2
11 1 2
13 17 2
9 13 2

6 9 0
4 8 0
13 6 0
1 1 0
17 2 0
12 12 0
10 10 1
14 2 1
0 19 1
16 8 1
4 0 1
15 0 2
15 1 2
13 15 2
17 9 2
9 13 2
