width 20
height 20
....................
@.............@.@...
...........@........
.....@..............
.......@........@...
@..@.....@.......@..
@.....@....@........
@@......@......@...@
@@@@................
@@..@........@..@...
....@.@..@..@.......
....@............@..
....................
.......@............
.@...@...@...@......
....@...............
..@..........@......
.....@.@............
.............@......
............@.......
16
14 0 0
19 4 0
12 5 0
1 15 0
15 19 0
16 12 0
5 2 1
18 14 1
11 13 1
3 6 1
4 1 1
18 9 2
0 15 2
9 0 2
2 3 2
16 0 2

18 3 0
9 4 0
18 17 0
19 14 0
19 15 0
6 1 0
16 18 1
2 4 1
15 8 1
2 6 1
7 14 1
15 5 2
11 0 2
12 5 2
15 19 2
0 19 2
