width 20
height 20
...............@....
@......@.....@......
...............@....
.@..................
.....@.@............
....................
......@.@......@....
..@.@...............
...........@........
..@.............@...
....@..@......@.....
................@.@.
........@...@.......
@...................
...........@..@.....
....................
...@................
...........@........
.........@.....@....
...........@...@....
16
2 5 0
18 5 0
1 15 0
12 3 0
12 9 0
12 6 0
1 2 1
1 4 1
4 5 1
18 10 1
9 7 1
4 17 2
5 19 2
3 9 2
8 3 2
6 13 2

11 18 0
19 14 0
16 10 0
12 3 0
8 19 0
14 4 0
16 6 1
13 18 1
18 0 1
18 10 1
9 13 1
16 18 2
4 13 2
4 6 2
18 18 2
17 18 2
