width 20
height 20
.@..@@@.............
...........@........
....................
............@.......
.@...........@.@....
....................
......@........@....
........@...@.@.....
..................@.
..@..@...@..........
..............@.....
...@................
@....@..@...........
@......@............
@.............@.....
@@@....@............
@@@.........@.@.....
@@@.................
@@@.....@..@........
@@@.....@@.@@.......
16
1 12 0
2 1 0
15 19 0
14 11 0
4 9 0
13 11 0
12 10 1
4 17 1
5 7 1
5 8 1
16 15 1
3 7 2
4 19 2
16 18 2
6 17 2
6 13 2

9 5 0
4 3 0
18 11 0
1 3 0
5 10 0
7 2 0
1 1 1
18 4 1
5 6 1
6 18 1
19 9 1
1 13 2
12 8 2
0 5 2
12 1 2
5 11 2
