width 20
height 20
@...................
....@...............
@........@..........
.@............@.@...
.................@..
...........@...@..@.
...@.@...@..........
....@.........@.....
..........@.@.......
...........@........
...@................
........@...........
.........@..........
....@........@...@..
...@.........@......
....@...............
...........@..@..@..
....................
...........@........
.............@.....@
16
19 0 0
18 2 0
9 15 0
3 1 0
0 15 0
15 8 0
11 8 1
13 3 1
1 12 1
5 2 1
14 19 1
5 4 2
5 9 2
13 12 2
7 4 2
19 13 2

1 4 0
7 12 0
15 15 0
17 11 0
2 12 0
8 1 0
10 3 1
16 2 1
6 16 1
17 19 1
7 14 1
19 17 2
13 11 2
15 14 2
7 3 2
1 13 2
