width 20
height 20
...@...............@
......@.........@..@
...................@
....@......@.......@
....................
...............@....
........@...@....@..
....@..........@..@.
....................
.......@@.......@...
.......@@........@..
..@....@........@...
....@..@@...........
..............@.....
.......@............
........@.........@@
.....@....@.......@@
...@..........@@@@@@
........@....@@@@@@@
.....@...@....@@@@@@
16
6 7 0
11 15 0
2 16 0
18 4 0
7 1 0
5 0 0
19 5 1
13 14 1
12 1 1
19 14 1
8 3 1
17 5 2
3 19 2
18 14 2
17 3 2
8 7 2

4 6 0
10 6 0
8 5 0
12 19 0
15 0 0
15 12 0
18 5 1
12 18 1
6 3 1
15 8 1
9 3 1
3 19 2
2 17 2
14 16 2
13 2 2
9 8 2
