width 20
height 20
@...................
@.@.................
...........@........
.....@..............
....@....@....@.....
.............@..@...
.@...@..............
....@...............
..@.......@.@.......
..............@.....
........@........@..
...@.@.........@....
...........@........
.......@....@.......
.@..........@.......
...@.@..........@...
....................
....................
..@.................
....................
16
8 7 0
0 7 0
3 13 0
13 9 0
3 6 0
8 3 0
16 2 1
18 3 1
7 6 1
15 3 1
7 17 1
0 18 2
11 16 2
10 9 2
9 0 2
1 4 2

6 7 0
0 6 0
4 17 0
13 9 0
13 7 0
15 6 0
18 17 1
12 6 1
10 6 1
4 19 1
8 11 1
1 16 2
11 4 2
12 9 2
6 12 2
3 7 2
