width 20
height 20
....................
...@...@....@.......
...@................
.......@............
.........@..........
....@.........@.....
....................
.......@....@.......
....@.@.............
..........@.@...@...
....@........@...@..
..............@.....
..................@.
.........@..@@@.....
..@..........@......
.....@........@.@...
..@.................
....................
.......@....@.......
.......@....@@@@@.@@
16
5 8 0
9 10 0
6 13 0
16 12 0
11 7 0
7 17 0
15 18 1
7 12 1
10 7 1
5 2 1
5 1 1
3 6 2
16 1 2
14 3 2
0 19 2
15 12 2

5 8 0
16 4 0
9 16 0
18 10 0
16 14 0
1 9 0
10 1 1
19 1 1
10 2 1
15 15 1
19 18 1
19 5 2
0 19 2
11 12 2
18 0 2
5 7 2
