width 20
height 20
....................
.@@.................
.@@..@.....@.....@.@
........@.@...@....@
...............@....
........@...........
......@.............
@@...............@..
@@@@...@............
@...@...............
...@..@..@.......@..
........@......@....
.......@....@.......
............@.....@.
........@@..........
......@@@...........
..@...@........@....
...@...@..........@.
............@.......
@@..................
16
1 0 0
19 7 0
4 2 0
9 3 0
10 16 0
11 1 0
18 6 1
19 14 1
4 18 1
9 18 1
6 9 1
15 15 2
9 5 2
4 1 2
9 17 2
19 6 2

9 13 0
11 12 0
12 8 0
11 10 0
6 7 0
7 0 0
18 6 1
4 1 1
17 0 1
0 6 1
17 5 1
13 15 2
17 14 2
16 18 2
18 2 2
4 11 2
