width 20
height 20
....................
.......@.@...@......
....................
@.....@.............
...........@........
....@....@...@...@..
.@....@.............
.......@..........@.
@@........@.....@...
.............@.@....
...@................
......@.............
............@.......
...@.....@....@.@...
....................
.....@..@...........
...............@....
..........@.........
..@.....@...........
....................
16
5 9 0
14 8 0
17 6 0
14 15 0
9 2 0
4 0 0
17 15 1
19 8 1
19 15 1
17 7 1
2 2 1
10 1 2
12 3 2
9 9 2
9 7 2
16 7 2

17 0 0
9 12 0
7 5 0
8 4 0
6 2 0
8 16 0
10 13 1
0 14 1
4 12 1
6 16 1
2 2 1
17 15 2
12 18 2
19 1 2
17 2 2
16 2 2
