width 20
height 20
@@............@@....
@...................
@..........@........
....................
.....@.............@
..@.........@.......
........@.@....@....
............@.......
..@........@........
........@...........
.....@.......@..@...
..........@.........
...................@
.........@@.........
..............@.@...
......@.....@..@....
...@................
..@.............@...
..............@.....
....................
16
11 18 0
10 0 0
18 18 0
2 15 0
4 18 0
7 17 0
5 11 1
14 3 1
9 17 1
0 19 1
18 3 1
7 1 2
13 14 2
1 17 2
11 17 2
3 12 2

14 3 0
10 0 0
13 14 0
16 12 0
17 2 0
7 17 0
13 17 1
5 17 1
16 16 1
2 9 1
18 16 1
9 18 2
16 0 2
5 11 2
18 2 2
2 14 2
