width 20
height 20
@...............@@..
.................@..
..............@.....
...@................
......@.......@@....
...........@.......@
.@..............@...
....@...............
...................@
........@........@@@
.............@....@@
...@.......@......@@
.............@....@@
...@..........@..@@@
....@....@.......@@@
.@..........@....@@@
........@....@...@@@
....@............@@@
..................@@
@.......@..........@
16
3 0 0
10 3 0
15 2 0
8 14 0
10 16 0
1 4 0
11 16 1
4 9 1
8 17 1
7 19 1
9 18 1
19 1 2
5 8 2
7 12 2
6 3 2
18 5 2

4 2 0
16 11 0
2 13 0
18 1 0
18 0 0
1 1 0
10 10 1
10 8 1
12 3 1
5 2 1
14 19 1
19 3 2
6 6 2
14 10 2
7 3 2
9 17 2
