width 20
height 20
..........@........@
........@........@..
..@..........@.@..@.
.....@.@............
......@..........@@@
.@.........@.@...@@.
..@...@.............
...........@...@....
.@..@...............
....................
......@.@......@....
.............@......
.....@..............
...............@..@.
........@...........
....@......@........
.......@.......@....
.@......@....@......
..@.........@.......
.........@....@.....
16
17 2 0
10 12 0
15 11 0
2 13 0
6 15 0
8 5 0
0 4 1
7 17 1
17 15 1
1 13 1
3 17 1
3 19 2
19 1 2
19 9 2
7 11 2
19 10 2

0 3 0
3 11 0
0 0 0
9 6 0
0 2 0
0 6 0
8 16 1
14 7 1
13 18 1
10 17 1
17 3 1
14 15 2
4 18 2
10 3 2
14 13 2
17 15 2
