width 20
height 20
.........@@@@.......
@.................@.
...................@
......@............@
...@.....@.....@...@
..@.....@..@.......@
..................@@
..................@.
....@.....@.@.......
.....@.........@....
.................@..
.@.......@..........
...@................
....@...@....@......
............@.......
..@.............@...
...@........@.......
..@....@.....@......
.....@..............
...................@
16
3 7 0
1 13 0
16 10 0
0 10 0
17 5 0
19 16 0
1 14 1
3 6 1
13 3 1
3 17 1
7 6 1
0 13 2
5 7 2
17 14 2
1 8 2
5 4 2

19 17 0
0 16 0
5 5 0
11 18 0
12 4 0
1 0 0
13 5 1
17 17 1
2 18 1
12 17 1
1 13 1
10 3 2
1 10 2
18 8 2
6 12 2
6 18 2
