width 20
height 20
....................
.......@..@.........
....@........@......
..........@.......@.
......@..@..........
............@@..@...
..........@.........
.....@..........@...
.............@.@....
....................
...@........@.......
...@..@.............
.........@..@.......
...............@....
..@......@....@.....
...@................
......@....@....@...
.....@..............
....................
@............@..@...
16
3 5 0
2 1 0
8 19 0
2 18 0
15 0 0
12 1 0
7 0 1
14 16 1
18 8 1
0 18 1
15 6 1
8 17 2
8 14 2
3 1 2
0 5 2
10 7 2

19 19 0
10 8 0
14 18 0
2 9 0
18 2 0
4 9 0
8 15 1
12 15 1
8 6 1
5 0 1
9 1 1
17 0 2
16 13 2
7 0 2
2 2 2
10 7 2
