width 20
height 20
..........@@@@......
.@..@...............
...@................
..@..........@.@....
........@........@..
...@.@..............
........@...@...@...
....................
.@....@..........@..
.............@......
......@.............
.........@..........
.......@............
....................
.@.@....@...........
............@.......
..............@..@..
....................
...........@........
...................@
16
12 17 0
17 18 0
10 6 0
18 18 0
5 13 0
4 11 0
10 17 1
8 3 1
17 14 1
4 2 1
9 8 1
3 4 2
9 17 2
16 14 2
13 14 2
17 9 2

0 2 0
12 18 0
9 6 0
18 18 0
1 4 0
2 9 0
3 11 1
7 4 1
1 10 1
19 17 1
0 19 1
6 2 2
10 7 2
0 18 2
9 0 2
1 19 2
