width 20
height 20
@@@@..@@............
@@@@..@@.......@.@..
@.....@.......@.@...
.......@..@.@.......
......@.............
....................
...............@.@..
.@...@......@.......
.@.@...........@.@..
....................
........@.....@.....
...@@.......@.......
......@....@....@...
...@.....@..@.@.....
....................
...@................
....@........@.@....
.......@...........@
.................@@@
@.....@...........@@
16
19 11 0
7 12 0
9 4 0
16 1 0
15 11 0
1 16 0
16 8 1
12 15 1
14 16 1
6 17 1
7 10 1
5 14 2
5 15 2
7 9 2
3 6 2
13 18 2

2 5 0
4 19 0
4 9 0
0 18 0
2 12 0
13 7 0
0 6 1
17 7 1
0 5 1
16 5 1
9 15 1
16 0 2
8 17 2
18 15 2
2 4 2
15 18 2
