width 20
height 20
@...........@@.....@
@......@............
@.............@.....
..@.................
................@...
..........@..@.@....
..@.@.@..@......@...
........@...........
.......@......@.....
.@..@............@..
...........@........
..@.................
......@.........@...
....@......@...@....
....................
.@..............@@..
....................
...........@.....@..
....................
....................
16
18 5 0
13 14 0
9 5 0
4 2 0
14 6 0
14 9 0
11 16 1
1 8 1
6 9 1
8 8 1
19 2 1
14 18 2
10 9 2
15 9 2
14 3 2
18 18 2

12 3 0
16 17 0
16 19 0
15 0 0
14 6 0
9 11 0
3 0 1
14 17 1
17 2 1
8 9 1
11 2 1
3 3 2
0 6 2
10 2 2
18 16 2
2 15 2
