width 20
height 20
..................@@
....@...........@.@@
..........@...@.....
.............@......
................@...
..@...@.............
............@.......
...@...........@.@..
......@.......@.....
............@.......
...@..@...@.........
..............@.....
.....@........@....@
...........@........
......@.............
..@.@..........@....
@...................
@......@.@...@......
@................@..
@@..................
16
1 2 0
5 19 0
16 19 0
12 5 0
15 4 0
14 15 0
5 4 1
16 9 1
5 8 1
16 18 1
8 2 1
10 6 2
4 12 2
5 10 2
12 14 2
16 12 2

14 7 0
8 19 0
6 12 0
6 18 0
9 14 0
10 0 0
11 17 1
17 19 1
4 8 1
4 14 1
17 14 1
2 14 2
4 4 2
5 10 2
8 13 2
16 12 2
