width 20
height 20
..............@@@...
...............@@@..
..@......@....@@....
.@..@.......@.......
...@..@.@........@..
....................
@.........@..@....@.
.......@......@.....
..............@.....
........@...@...@@..
.@.........@........
..@...@.....@.......
.@.@.........@.@....
....................
............@..@..@.
..@@@...........@...
@@@@....@....@......
@@@....@............
@@...............@@.
@@..............@@@@
16
8 3 0
3 11 0
19 7 0
8 12 0
9 0 0
4 4 0
19 15 1
2 10 1
15 8 1
8 19 1
3 14 1
12 12 2
14 9 2
2 14 2
5 7 2
5 3 2

0 15 0
19 5 0
6 19 0
5 17 0
1 2 0
18 16 0
0 7 1
16 18 1
15 7 1
18 12 1
10 10 1
11 16 2
9 8 2
18 1 2
5 6 2
10 17 2
