width 20
height 20
@.....@........@@@@@
@...@..........@@@@@
................@@@@
............@....@@@
...@.....@......@@@.
....@..........@@...
...@.........@.....@
................@...
.....@....@.........
.......@......@.....
.....@............@.
................@...
......@...@.@.......
.@.......@@@..@...@.
...@.....@@.........
....@........@.@....
@.......@...........
.....@..@...@.......
......@.............
..@....@.@..........
16
8 12 0
18 5 0
4 6 0
15 18 0
10 1 0
5 18 0
15 2 1
5 7 1
3 9 1
5 5 1
8 1 1
10 17 2
16 16 2
15 9 2
13 4 2
11 6 2

8 10 0
14 16 0
5 4 0
15 19 0
2 18 0
7 16 0
5 18 1
10 6 1
2 5 1
10 11 1
14 8 1
14 15 2
11 0 2
8 8 2
11 19 2
10 10 2
