width 20
height 20
@...................
....................
.....@..............
...............@....
.@.......@....@.....
...@......@...@.....
.....@...........@..
@...................
.....@..@...........
....................
..@..........@......
..................@.
.....@.......@......
..............@.@...
....@.@.............
@@................@.
@@...@.........@....
.........@....@.....
@...@.............@.
@...................
16
19 8 0
8 4 0
8 7 0
7 17 0
3 16 0
9 10 0
14 14 1
8 19 1
19 7 1
13 9 1
12 6 1
15 8 2
7 11 2
4 1 2
2 11 2
18 14 2

0 8 0
11 6 0
19 4 0
11 18 0
5 4 0
8 10 0
2 1 1
17 2 1
1 19 1
8 0 1
17 19 1
3 4 2
17 16 2
0 1 2
6 18 2
10 15 2
