width 20
height 20
....................
.....@.@............
...........@........
..@.@...............
...............@....
................@...
.@..@...............
.........@.......@..
...@................
......@.....@.......
........@.......@...
.........@..........
....@...............
...............@....
...................@
...........@...@....
......@.............
..........@.......@.
...................@
.........@.........@
16
17 4 0
6 17 0
11 6 0
17 19 0
19 0 0
13 7 0
8 8 1
7 9 1
13 5 1
8 11 1
2 12 1
8 18 2
13 11 2
12 6 2
6 5 2
18 15 2

0 14 0
17 2 0
16 16 0
17 14 0
14 5 0
1 17 0
17 10 1
11 6 1
4 19 1
17 18 1
9 15 1
8 9 2
3 19 2
17 9 2
18 19 2
11 5 2
