width 20
height 20
@...................
@..............@....
....@..@.........@..
......@.@.......@...
...........@.@......
....................
..@..@.@.....@......
....@....@......@...
..@.......@....@....
....................
.........@.....@....
.....@.......@......
....................
...........@........
....@...............
.@.............@....
......@......@......
.....@.....@...@.@..
....................
..............@.....
16
18 2 0
0 11 0
19 9 0
9 2 0
5 8 0
14 7 0
11 2 1
0 3 1
7 12 1
5 1 1
16 6 1
2 5 2
8 16 2
11 8 2
19 17 2
0 8 2

2 17 0
1 11 0
6 0 0
5 16 0
11 10 0
1 18 0
17 5 1
11 18 1
18 0 1
17 16 1
16 1 1
7 15 2
10 16 2
2 19 2
2 7 2
10 19 2
