width 20
height 20
.@..................
.................@..
..@.@.......@..@....
.......@............
....................
...@................
........@...@.......
..................@.
....................
.............@......
.@...@..........@...
..@.....@.@.........
............@.......
..@.@.@.............
...........@........
.@....@@....@.......
......@@............
..........@.@.......
....................
.@..................
16
14 2 0
15 17 0
16 17 0
18 3 0
6 3 0
3 10 0
4 4 1
10 19 1
0 16 1
0 8 1
9 5 1
19 10 2
0 18 2
8 8 2
0 2 2
3 0 2

0 2 0
16 14 0
1 1 0
2 15 0
5 17 0
13 6 0
7 6 1
8 9 1
1 9 1
17 18 1
10 16 1
2 1 2
11 1 2
7 1 2
14 7 2
6 5 2
