width 20
height 20
....................
.......@...@@.......
.@.........@........
...........@........
.......@............
.........@.....@.@..
.@..................
.......@............
....@..........@....
..........@.....@...
........@.....@.....
@@@.................
@.....@....@........
.........@.......@..
.......@...@........
....................
..@.................
........@........@..
......@......@......
.............@......
16
14 6 0
4 12 0
4 19 0
19 15 0
17 10 0
16 14 0
19 4 1
2 13 1
1 8 1
0 14 1
0 8 1
16 16 2
2 6 2
15 2 2
5 16 2
0 7 2

13 3 0
5 12 0
19 4 0
12 3 0
9 1 0
18 15 0
19 17 1
4 11 1
1 7 1
8 5 1
1 9 1
0 2 2
17 10 2
12 2 2
1 3 2
1 5 2
