width 20
height 20
..@@@...............
...@.............@..
......@..@.@........
...@................
.................@..
........@.@.........
............@...@...
......@.............
@@..................
..@.@...............
.....@........@.....
..@.........@.......
..........@......@..
......@.......@...@@
..@.........@......@
....................
....................
.@@..@...@..........
............@.......
...............@....
16
19 6 0
5 4 0
0 13 0
10 7 0
13 13 0
2 13 0
19 9 1
4 17 1
16 3 1
7 14 1
2 4 1
16 17 2
19 18 2
3 11 2
4 2 2
12 16 2

19 10 0
7 1 0
2 4 0
1 11 0
7 8 0
2 13 0
0 18 1
19 4 1
9 6 1
4 14 1
11 7 1
6 0 2
12 10 2
3 11 2
12 9 2
11 9 2
