width 20
height 20
..................@@
...@...............@
...................@
..@....@.@.........@
....@...........@..@
..@.....@.@....@....
............@.@...@.
..........@.........
........@......@...@
.............@.....@
.......@..@.........
....@.........@.....
............@.......
....................
....@.........@.....
.........@.@........
......@.............
.....@@.......@.....
....@@....@.........
....@............@..
16
8 0 0
7 5 0
6 13 0
16 15 0
6 6 0
16 13 0
1 19 1
2 10 1
7 2 1
1 14 1
3 0 1
16 6 2
11 18 2
14 2 2
15 16 2
2 18 2

8 0 0
9 14 0
5 15 0
8 14 0
11 11 0
16 3 0
1 19 1
1 0 1
6 4 1
10 12 1
18 18 1
6 8 2
0 0 2
13 10 2
3 6 2
17 1 2
