width 20
height 20
@...@@@@@..........@
@......@@...........
@...................
@.....@.....@.......
@....@....@.........
...@.....@......@...
....................
....................
....................
@.@@...@.@.......@..
@@@@...@............
@@@@....@....@.@....
@@..................
.......@..@.........
.........@.@.@......
.......@............
..@@................
................@...
........@....@@@....
.............@@@....
16
17 13 0
2 3 0
18 11 0
17 1 0
6 15 0
12 17 0
2 17 1
12 11 1
12 19 1
5 13 1
5 7 1
11 12 2
18 3 2
0 7 2
5 8 2
13 9 2

10 1 0
8 12 0
15 4 0
17 1 0
12 0 0
0 6 0
18 1 1
19 16 1
16 10 1
11 18 1
15 16 1
1 3 2
0 19 2
2 7 2
3 8 2
12 12 2
