width 20
height 20
@@............@@@...
@@..................
@@..@...............
@@........@....@....
@.@..........@......
.................@..
....................
.@.............@....
........@.@.........
...@.@......@.......
........@.@....@....
......@............@
....@......@.......@
..@.........@...@..@
..................@@
.................@@@
@.........@.......@@
.........@...@....@@
...@................
............@@......
16
1 11 0
1 9 0
7 10 0
18 18 0
16 16 0
14 4 0
2 2 1
8 19 1
3 14 1
14 18 1
16 3 1
12 10 2
19 1 2
15 8 2
17 10 2
19 2 2

9 19 0
18 2 0
0 8 0
16 9 0
4 0 0
5 12 0
0 18 1
7 7 1
2 10 1
9 11 1
18 6 1
8 13 2
6 13 2
1 17 2
7 14 2
5 19 2
