width 20
height 20
.........@.........@
@......@............
@....@...@....@..@..
@.@.@...............
....................
............@.......
....@........@.@....
......@.@.@.........
..............@.@...
....@........@......
.......@............
...........@.......@
...@.........@......
.......@............
@.......@...........
@.@......@...@......
@@..................
@@..................
@@@.........@.....@.
@@@@.........@.@....
16
19 12 0
3 8 0
17 15 0
4 5 0
10 16 0
6 18 0
6 5 1
18 4 1
12 13 1
3 0 1
2 4 1
17 16 2
12 6 2
11 18 2
5 14 2
0 0 2

19 12 0
15 3 0
18 11 0
4 5 0
11 18 0
19 1 0
18 12 1
5 5 1
13 13 1
6 1 1
2 4 1
11 3 2
10 6 2
11 19 2
4 14 2
14 6 2
