width 20
height 20
....@@...@@.........
.........@@@........
......@...@@........
....@...........@...
.....@......@....@..
.........@..........
..................@.
@@...@..............
@...@....@...@..@...
.....@.....@........
....................
......@..@...@@@.@..
...............@..@.
........@...........
.......@............
....................
.............@......
.......@.......@....
@.......@...........
......@@@...........
16
1 14 0
19 11 0
0 5 0
6 15 0
9 4 0
1 18 0
6 5 1
19 10 1
7 0 1
0 2 1
10 3 1
3 16 2
15 19 2
18 14 2
17 17 2
11 3 2

10 3 0
6 13 0
14 17 0
0 4 0
17 13 0
12 14 0
13 0 1
0 0 1
2 8 1
2 0 1
14 18 1
18 1 2
12 7 2
19 0 2
0 2 2
11 3 2
