width 20
height 20
....@.............@@
..........@........@
.@.............@....
..............@.....
.........@..........
....................
........@....@...@..
....................
@..........@........
...@..@.............
...........@..@.....
............@.......
....................
..@.......@.....@...
.................@..
..................@@
....@.....@........@
....................
@...............@...
@..@...........@....
16
7 10 0
8 4 0
0 1 0
11 17 0
3 5 0
5 1 0
9 14 1
13 15 1
2 3 1
16 0 1
16 15 1
0 12 2
8 2 2
0 2 2
16 11 2
9 3 2

18 17 0
1 5 0
17 4 0
8 3 0
3 5 0
3 2 0
0 0 1
5 3 1
16 14 1
1 19 1
7 1 1
11 19 2
0 17 2
1 7 2
2 3 2
2 11 2
