width 20
height 20
.................@..
....................
.........@..........
..@.............@...
...................@
.........@..@.......
..@.....@.@.........
......@.............
....@.......@..@....
....................
@..@.@......@....@..
.......@............
............@..@....
.@...@..@...........
..@..@....@.@...@...
...........@........
....................
...@.@.@.....@......
..@........@..@.....
................@@@.
16
12 18 0
0 8 0
14 13 0
7 19 0
17 9 0
0 12 0
7 16 1
6 1 1
19 12 1
7 13 1
9 0 1
13 13 2
15 6 2
7 2 2
8 14 2
12 19 2

0 0 0
17 13 0
14 17 0
8 15 0
6 0 0
9 6 0
10 10 1
12 11 1
5 9 1
17 3 1
18 2 1
16 12 2
3 6 2
6 6 2
15 16 2
1 7 2
