width 20
height 20
@@@@@@@@..........@@
@@@@@@@@............
@@@@@@@.............
@@@@....@...........
@@@.......@....@....
@@@..........@......
@@...@......@.......
@@..@.@..@..........
@..............@....
........@...........
....................
..@......@..@.@.....
.@..@...@..@.....@..
...................@
........@..........@
....@.@..@......@..@
...................@
@.........@........@
................@...
................@...
16
15 3 0
14 14 0
17 2 0
14 4 0
9 6 0
15 12 0
18 9 1
16 6 1
5 8 1
2 15 1
16 14 1
4 3 2
8 11 2
12 9 2
12 5 2
1 18 2

12 13 0
0 14 0
1 11 0
14 4 0
17 18 0
15 14 0
2 15 1
9 18 1
8 4 1
0 10 1
6 13 1
9 6 2
5 13 2
5 19 2
1 19 2
5 15 2
