width 20
height 20
@@..................
@.........@.........
....@.@.............
...@.....@.@..@.....
....................
............@.......
.......@............
..@......@.....@.@..
.....@..............
....................
...........@.......@
.....@....@..@..@..@
@...................
....................
.........@.@......@@
..............@...@@
......@.@..........@
..........@........@
......@.......@....@
.@...............@@@
16
6 7 0
12 15 0
1 8 0
18 4 0
2 3 0
1 2 0
15 11 1
0 4 1
6 17 1
14 4 1
0 19 1
11 0 2
6 10 2
7 13 2
0 8 2
8 3 2

8 4 0
18 6 0
0 5 0
3 4 0
11 12 0
5 18 0
1 1 1
3 0 1
17 15 1
14 4 1
4 0 1
3 15 2
7 10 2
9 19 2
14 14 2
13 18 2
