width 20
height 20
.................@@@
.................@@@
............@......@
.....@....@....@....
....................
....................
.@...@..............
..@...........@.....
....................
..@..............@..
...@.........@......
......@.@...........
@...................
.....@.....@.....@..
......@...........@.
@.............@.....
@........@.....@.@..
@......@...@....@.@.
@...................
@...................
16
5 14 0
5 8 0
12 19 0
1 16 0
12 14 0
19 11 0
1 0 1
8 12 1
15 10 1
1 2 1
1 15 1
8 6 2
19 3 2
8 1 2
18 15 2
4 3 2

4 13 0
19 14 0
0 4 0
17 3 0
8 7 0
13 7 0
0 13 1
16 7 1
3 7 1
2 8 1
9 12 1
16 5 2
19 3 2
8 1 2
1 2 2
18 19 2
