width 20
height 20
.................@@@
....................
....@...............
.....@.@....@.......
...............@....
.....@....@.@.@.....
..@..........@......
....@....@..........
.......@............
................@...
.@.....@....@.......
....................
@.............@.....
.........@.......@..
.......@.....@......
........@.@.........
@@@.................
@@@.............@@..
@@......@.......@...
@...................
16
5 6 0
4 9 0
18 12 0
0 4 0
13 18 0
0 14 0
18 10 1
19 5 1
4 19 1
10 3 1
1 5 1
15 18 2
8 12 2
18 7 2
0 11 2
4 1 2

1 2 0
9 11 0
0 0 0
14 13 0
18 10 0
2 10 0
5 11 1
15 2 1
15 14 1
1 19 1
2 7 1
15 18 2
6 17 2
7 16 2
4 9 2
2 2 2
