width 20
height 20
....................
.@..@...............
...@..@.............
.....@.............@
....................
..........@.....@...
....................
....................
.............@......
....@...@.@........@
.............@.....@
................@...
....@....@.......@..
......@...@...@...@.
....................
........@...@..@@@..
..............@@@...
......@.............
.@.....@.@.@........
....................
16
2 16 0
15 3 0
13 19 0
10 17 0
10 3 0
6 10 0
3 16 1
9 5 1
0 2 1
7 14 1
7 8 1
9 17 2
4 11 2
19 15 2
4 16 2
5 16 2

6 6 0
7 10 0
5 17 0
11 3 0
6 18 0
16 18 0
2 17 1
19 12 1
0 15 1
16 12 1
12 6 1
5 11 2
18 5 2
17 14 2
8 4 2
12 7 2
