width 20
height 20
....................
....................
..@.................
....@....@..........
.....@.......@......
..@.................
....@......@........
..@.............@...
.......@............
........@...........
..@.................
.................@..
............@@......
.@..........@.......
....@...............
....................
..........@...@.....
...@.@.@.@.....@....
..................@.
....................
16
3 1 0
10 18 0
11 11 0
16 15 0
10 14 0
2 11 0
9 4 1
18 16 1
17 3 1
11 2 1
14 15 1
6 10 2
6 4 2
15 3 2
19 10 2
19 0 2

17 13 0
4 16 0
12 11 0
1 9 0
8 3 0
0 8 0
1 19 1
18 16 1
11 19 1
18 8 1
5 0 1
19 0 2
19 15 2
6 18 2
16 6 2
8 19 2
