width 20
height 20
..@.................
..........@.........
....................
.....@..............
@@@.....@...........
...........@....@...
....@.@.............
.......@...........@
.................@..
.@.........@.@......
......@...........@.
.............@......
....................
..@...........@@....
.........@....@@....
.............@@@@...
...@....@...@@......
....@...............
......@.............
....................
16
10 19 0
2 18 0
14 16 0
6 12 0
10 14 0
8 1 0
11 17 1
0 15 1
16 10 1
17 14 1
13 14 1
13 4 2
16 11 2
16 19 2
11 8 2
4 2 2

11 16 0
12 4 0
11 2 0
8 1 0
11 13 0
19 13 0
10 18 1
0 15 1
8 10 1
0 2 1
8 8 1
5 4 2
16 14 2
16 9 2
18 19 2
1 1 2
