width 20
height 20
@...@...............
.................@..
.@..................
..........@.@....@..
..@.................
.....@.@.@..@.@.....
...@..@......@......
....................
...........@.....@..
.@..............@...
.........@..........
...@...@............
.......@............
..........@.@.......
...........@........
..............@.@...
@........@.....@....
@@..................
@...................
@..@................
16
13 3 0
4 4 0
15 11 0
2 8 0
0 3 0
12 7 0
13 5 1
9 1 1
10 15 1
14 0 1
3 4 1
19 6 2
6 18 2
5 1 2
8 11 2
6 9 2

1 14 0
16 4 0
9 4 0
19 17 0
16 19 0
1 18 0
13 13 1
8 1 1
15 13 1
2 19 1
18 18 1
16 8 2
1 12 2
9 19 2
8 11 2
17 10 2
