width 20
height 20
....@@@@...@@@@@@@@@
..@........@@@@@@@@@
...........@@@@@@@@@
...........@@@@@@@@@
....@.........@@@@@@
..@............@@@@@
...@.......@...@.@@@
....@.@.@...........
....................
............@.......
.....@....@.....@...
........@......@....
.@@.................
@.......@...........
@..........@..@.....
........@...........
.....@...@....@....@
..@.@.......@.......
..@.................
@...................
16
11 8 0
10 8 0
12 19 0
4 9 0
6 15 0
7 8 0
11 5 1
3 9 1
10 7 1
10 16 1
12 10 1
12 8 2
9 6 2
10 2 2
3 17 2
7 10 2

11 10 0
8 10 0
9 5 0
16 18 0
12 13 0
19 19 0
12 6 1
4 11 1
7 11 1
9 1 1
14 6 1
9 19 2
7 9 2
13 7 2
5 6 2
18 19 2
