width 20
height 20
@@@................@
..........@...@.....
............@.....@.
............@.......
..................@.
..@....@............
...@.........@.@....
.......@..@.........
....................
...@..@.....@.@.....
........@..........@
.........@..........
....@...............
........@....@......
....................
.....@..@...........
...@................
.........@..........
...........@......@.
............@.......
16
15 12 0
12 12 0
11 3 0
7 4 0
13 2 0
13 1 0
9 1 1
16 19 1
2 12 1
12 11 1
9 12 1
16 10 2
4 19 2
2 7 2
15 8 2
19 6 2

9 19 0
7 16 0
3 19 0
8 7 0
13 2 0
14 18 0
11 13 1
6 1 1
4 7 1
6 17 1
16 19 1
17 10 2
6 19 2
11 6 2
15 7 2
0 12 2
