width 20
height 20
.............@@.....
....................
@..........@......@.
@...................
@.@...@.....@...@...
....................
...@................
...........@........
........@@.....@....
..............@..@..
...@................
......@@.@......@.@.
.@.............@....
........@.@.......@.
@...@......@........
@......@.@..........
................@...
......@...@.@.@.....
.....@...@..........
....................
16
4 1 0
18 14 0
13 17 0
11 9 0
5 9 0
10 18 0
15 15 1
18 10 1
8 3 1
13 8 1
15 5 1
14 15 2
15 1 2
13 10 2
16 8 2
4 15 2

10 19 0
3 15 0
4 6 0
6 7 0
16 3 0
11 18 0
8 0 1
19 9 1
9 12 1
1 16 1
2 17 1
5 12 2
7 7 2
4 18 2
3 19 2
9 16 2
