width 20
height 20
..@..........@@@@@@@
..@..............@@@
....@.....@...@...@@
....................
....@.@..@..@.......
.....@.....@........
..........@....@....
.............@......
.....@...........@..
....................
...........@.@......
...@...........@....
......@...@.........
...@....@..@........
@.............@.....
@@...@..@@..........
@@......@.......@...
.............@......
@@....@@...........@
@@@@..@@...........@
16
2 12 0
0 6 0
17 4 0
11 14 0
17 14 0
13 4 0
10 10 1
16 9 1
10 14 1
7 12 1
4 18 1
17 12 2
4 0 2
16 5 2
0 1 2
7 5 2

9 10 0
4 5 0
9 8 0
12 14 0
5 11 0
3 2 0
16 1 1
3 18 1
2 4 1
13 2 1
18 3 1
7 12 2
3 0 2
6 15 2
16 18 2
0 0 2
