width 20
height 20
....@........@...@@@
.................@@@
..........@..@.@.@@@
.......@....@....@@@
....@.@...@.........
.@.@.......@...@....
.....@........@.....
......@.............
....@........@....@.
...@...............@
....@...@.....@.....
.......@....@.......
..@......@.........@
....@......@.......@
...............@...@
....................
..............@.....
....................
...@.........@......
....................
16
9 1 0
1 2 0
4 6 0
19 4 0
4 17 0
5 15 0
10 13 1
7 8 1
1 10 1
9 6 1
14 1 1
13 1 2
2 11 2
6 6 2
2 7 2
17 15 2

18 19 0
1 2 0
17 9 0
6 16 0
11 2 0
11 0 0
15 3 1
7 8 1
0 7 1
8 6 1
2 11 1
5 9 2
13 1 2
5 15 2
19 7 2
19 11 2
