width 20
height 20
....................
@.........@.......@.
.....@..............
......@.....@..@....
....................
@...@..@............
....@@.........@....
............@...@.@.
.@...@...@..........
.............@.@....
..@........@.....@..
....@.....@.@.......
.@..................
......@.......@...@.
...@........@.......
......@.............
..........@.@...@...
..@.................
.......@............
....................
16
13 14 0
14 11 0
0 16 0
18 17 0
8 13 0
4 12 0
18 14 1
6 2 1
19 19 1
2 11 1
19 11 1
11 5 2
5 1 2
1 4 2
1 2 2
19 2 2

17 6 0
1 2 0
9 18 0
2 12 0
14 11 0
16 19 0
16 17 1
0 7 1
14 12 1
7 2 1
13 14 1
2 19 2
1 1 2
0 8 2
18 17 2
18 5 2
