width 20
height 20
@@@@@..@@@..........
@@@@@@..@...........
@@@@....@...........
@@@@........@.......
@@........@.........
......@........@....
.............@...@..
.@..................
.....@...@..........
..@.....@.....@.....
...@.......@........
..@...........@.....
.................@..
...@...@............
.@...........@.@....
.....@..@...........
...@.......@..@.....
...........@.....@..
.@..................
........@...........
16
11 14 0
11 13 0
1 8 0
19 15 0
13 10 0
17 4 0
11 18 1
13 13 1
9 19 1
12 4 1
18 6 1
2 19 2
3 17 2
4 2 2
0 14 2
1 12 2

16 13 0
16 5 0
18 7 0
0 5 0
9 14 0
2 12 0
12 18 1
14 18 1
1 10 1
0 17 1
17 16 1
2 19 2
7 18 2
18 18 2
13 5 2
18 11 2
