width 20
height 20
@...................
.............@......
....@.@@.@.@........
..........@...@.....
..@.........@..@....
.@........@......@..
....@...@.@.@.......
.................@..
....................
.....@...@.@......@.
....................
.........@..........
.@............@.....
............@....@..
.@....@......@.@....
....................
..........@..@......
..@...@.............
....................
....................
16
18 16 0
14 14 0
19 5 0
12 12 0
9 8 0
8 17 0
10 14 1
6 5 1
4 8 1
2 19 1
16 13 1
7 8 2
16 14 2
11 14 2
8 19 2
17 18 2

3 6 0
5 1 0
0 9 0
12 12 0
9 8 0
7 18 0
5 3 1
8 1 1
17 11 1
12 3 1
10 8 1
1 17 2
3 13 2
2 3 2
11 13 2
4 5 2
