width 20
height 20
...........@........
...............@....
....................
....................
..@.......@.@.......
....@..........@....
@...................
@................@..
..@......@..........
......@.........@...
................@...
.@....@@............
.............@......
...@...@.........@..
....................
....@..@............
...........@........
......@..@.......@..
..@............@....
....@@.......@......
16
19 19 0
11 19 0
0 8 0
14 18 0
12 7 0
17 11 0
14 5 1
3 18 1
11 1 1
16 8 1
18 2 1
15 11 2
6 10 2
8 17 2
18 19 2
16 0 2

5 15 0
11 19 0
6 5 0
0 15 0
10 6 0
18 11 0
2 11 1
10 18 1
12 3 1
12 7 1
13 18 1
15 11 2
0 0 2
8 15 2
5 11 2
0 11 2
