width 20
height 20
....@...............
...@................
............@.......
..........@.........
...........@...@....
.....@.............@
....................
.....@.@............
................@.@.
..@....@....@.......
......@@...@...@@...
....................
...@.....@..@.......
.......@..@.........
....................
.............@......
.@..................
........@.@.......@.
.....@.....@.......@
@...@@.........@...@
16
7 18 0
15 0 0
15 9 0
12 16 0
6 17 0
14 8 0
17 6 1
11 6 1
6 8 1
10 5 1
15 5 1
1 19 2
5 9 2
2 16 2
12 10 2
17 17 2

10 4 0
15 9 0
17 12 0
10 8 0
4 16 0
0 16 0
12 8 1
10 19 1
19 1 1
10 5 1
15 5 1
8 3 2
0 2 2
9 8 2
18 13 2
0 0 2
