width 20
height 20
@@............@.....
@@..................
@@...@...@.......@..
....@...............
.......@......@.....
.................@..
.@........@.......@.
.........@@..@......
.....@..............
...............@....
...@..@..@..........
...........@........
...............@....
...@.....@......@.@.
....................
.....@..............
@.........@....@..@.
@@..................
@@@..@@.............
@@...@@@@...........
16
19 11 0
12 19 0
16 5 0
7 11 0
18 17 0
18 9 0
5 10 1
15 14 1
5 4 1
11 9 1
14 8 1
2 8 2
2 17 2
0 12 2
0 8 2
5 11 2

5 10 0
7 16 0
0 15 0
8 14 0
12 10 0
12 2 0
5 6 1
5 1 1
2 2 1
11 9 1
5 4 1
7 8 2
5 9 2
10 11 2
19 1 2
19 0 2
