width 20
height 20
.....@@.............
....................
@.@..........@......
.........@..........
....@..@..........@.
............@.......
..@.................
.....@.@............
.........@....@.....
....................
.....@..............
...........@........
...@................
..@.........@.......
.....@.........@....
...@................
.............@......
........@.....@.....
..............@@....
......@....@@.......
16
6 13 0
6 6 0
10 11 0
18 7 0
3 18 0
6 15 0
18 14 1
13 3 1
10 7 1
13 14 1
18 16 1
17 19 2
15 9 2
15 17 2
6 14 2
15 10 2

14 5 0
13 18 0
2 1 0
13 17 0
9 14 0
1 10 0
8 5 1
6 9 1
11 5 1
0 1 1
19 16 1
11 3 2
8 2 2
1 9 2
13 11 2
10 7 2
