width 20
height 20
................@...
...........@....@...
.....@..............
.@......@...........
.....@..........@...
.........@..........
.....@..............
...........@........
@.............@.....
@@@....@............
......@.@......@....
..........@........@
........@..@.@......
....................
.....@..............
@..........@......@.
@..@................
.....@..........@...
.................@..
@...................
16
6 14 0
5 12 0
8 5 0
8 2 0
11 17 0
18 12 0
13 8 1
19 2 1
6 0 1
3 14 1
7 5 1
0 5 2
2 8 2
9 8 2
4 2 2
15 2 2

9 11 0
16 2 0
19 17 0
10 13 0
18 4 0
17 16 0
3 1 1
10 4 1
11 6 1
1 11 1
16 6 1
15 19 2
7 1 2
18 19 2
4 3 2
15 2 2
