width 20
height 20
..........@.........
....................
....@...@...@..@....
...@.............@..
........@...........
.........@....@..@..
..@.............@...
.@....@.......@.....
.....@....@.........
.................@..
...@.@.....@...@....
...@..@.............
........@....@..@...
....@...............
.........@..........
@@........@.........
....@...............
@.@............@.@..
@@........@.....@.@.
@@..................
16
12 1 0
16 14 0
13 0 0
13 3 0
5 0 0
4 18 0
2 2 1
0 12 1
5 3 1
5 15 1
18 1 1
3 15 2
16 8 2
7 12 2
2 15 2
8 17 2

15 1 0
18 11 0
13 0 0
6 17 0
19 1 0
1 1 0
19 11 1
9 17 1
10 9 1
18 0 1
17 10 1
4 5 2
18 14 2
14 16 2
18 2 2
0 10 2
