width 20
height 20
@...................
....@.@.............
@.......@...........
@........@....@.@...
..@.................
@....@.......@...@..
....................
....................
....@..@.......@@...
....................
....................
.@...@..........@...
...@.......@...@....
......@.......@.....
.@...........@......
.@........@......@..
.@...@.......@......
..@...@..@..........
.................@..
...........@.......@
16
8 7 0
16 17 0
13 15 0
18 0 0
19 8 0
18 15 0
18 2 1
19 15 1
11 1 1
16 12 1
8 4 1
2 18 2
0 13 2
11 6 2
13 18 2
16 9 2

12 3 0
9 2 0
15 3 0
0 19 0
19 10 0
15 18 0
7 4 1
13 4 1
18 8 1
1 9 1
5 0 1
11 9 2
7 15 2
18 12 2
15 17 2
19 7 2
