width 20
height 20
@................@@@
...........@.....@@@
................@@@@
...@.............@@@
......@...@....@....
...........@........
.......@......@.....
....................
.............@......
..@..@........@.....
..@.......@.......@.
....@.@.............
..@.....@....@......
...@.........@...@..
@..............@....
......@.....@.......
.............@......
.@..@.....@.........
....................
....................
16
7 11 0
11 2 0
8 16 0
7 17 0
1 15 0
11 16 0
3 12 1
14 13 1
7 4 1
3 2 1
12 14 1
14 19 2
5 13 2
5 3 2
6 19 2
11 11 2

15 10 0
14 0 0
15 3 0
6 9 0
0 5 0
11 18 0
15 0 1
14 13 1
19 19 1
0 3 1
11 13 1
5 0 2
16 1 2
4 5 2
18 7 2
18 4 2
