width 20
height 20
................@@@@
...@......@.@...@@@@
.............@.....@
............@...@...
.@..........@.......
....................
......@.............
..................@.
...........@.@......
...@..@.......@.....
.@..@......@........
........@...@..@....
......@.............
....@...@...@..@....
....................
...@.......@........
..........@......@..
.............@@@....
................@...
..........@@........
16
7 18 0
18 3 0
6 7 0
0 5 0
17 15 0
1 5 0
9 6 1
3 17 1
6 10 1
4 18 1
10 12 1
4 12 2
3 18 2
16 15 2
11 1 2
17 2 2

17 15 0
17 7 0
7 16 0
8 0 0
0 8 0
12 19 0
0 7 1
9 2 1
5 11 1
15 1 1
7 12 1
7 11 2
3 5 2
8 1 2
3 3 2
6 13 2
