width 20
height 20
@.......@.........@@
...................@
....@..............@
...............@...@
...@...@..@.........
....@...............
.....@.........@....
...........@.@....@@
..................@@
......@.@..@.......@
.........@.........@
......@..........@@@
.....@@.........@@@@
.@...@..@...@....@@@
.................@@@
..............@@@@@@
...........@@@@@@@@@
@..@......@@@@@@@@@@
.........@@@@@@@@@@@
.....@@@@@@@@@@@@@@@
16
9 12 0
5 16 0
15 10 0
17 5 0
1 15 0
7 7 0
12 7 1
5 17 1
4 14 1
7 18 1
9 9 1
5 4 2
4 10 2
7 8 2
11 5 2
6 0 2

0 3 0
7 16 0
4 9 0
17 6 0
6 7 0
1 19 0
0 14 1
14 7 1
12 15 1
18 2 1
6 18 1
7 3 2
4 7 2
4 10 2
1 12 2
0 19 2
