width 20
height 20
.............@@...@@
....................
...@.......@........
.@.....@.......@....
@....@........@.....
.......@...@...@....
....................
...........@........
.........@.....@....
.@..@...........@@..
.............@......
...@................
.....@....@.........
....................
...........@..@.....
.............@......
.................@..
...@.........@..@...
........@...........
....................
16
18 7 0
12 17 0
4 0 0
17 11 0
19 11 0
19 4 0
1 17 1
12 16 1
3 18 1
19 5 1
7 19 1
9 3 2
8 8 2
0 17 2
9 13 2
5 19 2

12 9 0
19 7 0
7 18 0
4 1 0
0 19 0
0 18 0
10 10 1
8 15 1
19 6 1
1 17 1
7 19 1
10 4 2
8 17 2
10 18 2
1 16 2
18 3 2
