width 20
height 20
....@..@@@........@@
.........@........@@
....@....@........@@
.....@.@...@......@@
..................@.
........@.....@.....
............@.......
..@...@.......@.....
..............@.....
....@...@...........
....................
..@..@..........@...
@..@.......@........
..................@.
@......@.@...@....@.
@.........@......@..
.....@......@.......
........@...........
...@................
........@...........
16
9 17 0
17 11 0
11 1 0
14 16 0
4 7 0
19 7 0
7 9 1
12 7 1
4 1 1
11 10 1
7 12 1
13 19 2
9 12 2
1 11 2
1 6 2
16 8 2

8 7 0
10 10 0
1 18 0
3 6 0
8 4 0
0 2 0
9 4 1
2 9 1
7 19 1
13 10 1
1 19 1
1 2 2
6 19 2
15 6 2
18 19 2
19 17 2
