width 20
height 20
....................
...@...@...........@
...................@
.........@@.........
.........@@.......@@
..@......@@.......@@
.....@.@....@.......
...................@
.....@..........@...
...@..@..@.......@..
.......@..@.........
................@...
....................
........@.....@.....
..@................@
...@....@.@.......@@
..........@.......@@
..........@....@..@@
..@.......@.......@@
....@.@@......@@.@@@
16
4 13 0
9 7 0
7 9 0
3 3 0
9 16 0
1 9 0
0 13 1
15 9 1
7 15 1
2 1 1
19 8 1
0 10 2
11 5 2
15 3 2
1 0 2
8 6 2

13 4 0
10 6 0
7 5 0
7 0 0
1 17 0
1 12 0
2 19 1
15 0 1
18 0 1
7 4 1
13 14 1
12 0 2
0 1 2
16 7 2
1 9 2
15 5 2
