width 20
height 20
................@@.@
...................@
....................
....................
.....@..............
.......@....@.......
..@.......@....@....
.@@....@.@..........
.@.........@@@......
........@..@@@......
.....@.@......@.....
....................
.......@............
..............@.....
....................
............@.@..@..
......@.........@...
@..........@.@......
@.........@.........
@@@.................
16
7 19 0
3 14 0
13 12 0
14 4 0
13 7 0
9 3 0
15 5 1
15 4 1
15 2 1
16 12 1
5 9 1
0 11 2
11 1 2
1 3 2
2 16 2
10 12 2

18 17 0
3 14 0
0 0 0
16 13 0
19 16 0
18 18 0
0 14 1
3 9 1
5 17 1
17 13 1
18 3 1
18 0 2
13 1 2
8 8 2
19 2 2
2 17 2
