width 20
height 20
..............@@@...
....................
@@..@.@..@...@......
@@...@..............
@@@....@....@.......
@............@...@..
...........@........
.@...@...@......@...
.......@....@.......
....................
..............@...@.
.......@........@...
....................
.@.....@....@.......
....................
....@..............@
.......@...........@
.@.......@........@@
...@.........@@.@..@
.@@@@...............
16
9 18 0
5 15 0
14 8 0
11 10 0
15 1 0
18 9 0
3 17 1
5 19 1
8 3 1
4 8 1
3 3 1
1 11 2
10 11 2
9 13 2
8 16 2
5 11 2

6 14 0
19 3 0
5 0 0
6 18 0
16 12 0
5 17 0
15 4 1
14 2 1
18 18 1
10 3 1
3 2 1
0 11 2
19 1 2
14 12 2
7 1 2
17 11 2
