width 20
height 20
@@..@@.....@........
@@..@.......@.......
....@.............@.
@......@.........@..
@...................
.....@....@.@.......
........@..@........
..............@.....
...@................
.@.......@..........
..............@.....
......@.............
....................
......@....@........
...@.@........@.@..@
@.@.......@........@
@...........@..@...@
....@......@....@..@
......@.............
....................
16
13 2 0
18 4 0
9 5 0
5 18 0
18 16 0
11 10 0
18 1 1
4 9 1
12 7 1
6 14 1
17 13 1
13 0 2
10 11 2
12 8 2
12 14 2
0 14 2

1 18 0
4 19 0
19 19 0
2 17 0
11 11 0
11 10 0
2 13 1
4 9 1
17 4 1
14 2 1
14 1 1
13 3 2
8 11 2
3 18 2
8 3 2
9 19 2
