width 20
height 20
....................
....................
...........@........
......@..@...@.@....
.......@............
..@................@
....@...@.........@@
...@.......@......@@
..@...........@...@@
........@....@.....@
....@...............
.............@......
......@.............
.....@..@...@.......
.@........@......@..
....................
.........@..........
.....@.@..........@.
...........@...@....
...@................
16
18 15 0
15 2 0
13 4 0
2 4 0
6 13 0
2 17 0
11 1 1
8 0 1
5 19 1
0 15 1
15 19 1
5 3 2
18 19 2
4 13 2
9 18 2
10 5 2

17 12 0
0 15 0
17 3 0
18 18 0
11 3 0
15 1 0
10 10 1
19 4 1
17 2 1
15 0 1
12 17 1
4 5 2
5 2 2
3 15 2
8 16 2
10 5 2
