width 20
height 20
......@@@@@.........
....................
...@.........@......
....@...............
........@......@....
....................
.@..........@....@..
.......@............
....@...............
................@...
.@.........@.@....@.
..@...........@.....
....@.@.@.@.........
...........@.....@.@
.......@......@....@
...............@....
..........@..@......
....@.......@.......
..................@@
.........@........@@
16
6 2 0
11 17 0
17 9 0
5 2 0
15 5 0
18 0 0
13 19 1
4 7 1
7 13 1
16 12 1
15 14 1
4 13 2
9 4 2
12 8 2
14 12 2
11 16 2

15 7 0
6 5 0
12 11 0
1 5 0
17 16 0
6 16 0
14 12 1
18 3 1
13 0 1
4 2 1
16 5 1
1 4 2
0 16 2
18 15 2
0 0 2
7 9 2
