width 20
height 20
....................
..............@.....
...........@.@......
......@.............
....@.......@.......
.@..................
......@..@..@.......
..........@..@...@..
....................
..........@.....@...
..@......@..........
....................
........@....@......
...............@...@
...@...............@
@@.................@
@@.........@.....@..
@@..................
@@..................
@@.@................
16
10 1 0
4 18 0
15 15 0
15 17 0
9 5 0
19 11 0
0 13 1
16 12 1
6 10 1
13 3 1
3 13 1
18 6 2
1 9 2
12 18 2
4 6 2
11 19 2

6 4 0
15 3 0
0 1 0
16 10 0
19 19 0
19 8 0
10 16 1
5 1 1
5 11 1
15 2 1
16 14 1
0 14 2
15 9 2
17 17 2
14 18 2
18 7 2
