width 20
height 20
@...................
@...................
......@.@....@......
...@@..@.@..........
.@@@................
@@@@................
@@@@......@..@......
@@@........@......@.
@@..........@.......
@@@@................
@@@.......@.........
@..............@....
...........@.@......
.................@..
............@.@..@..
.@...@.@.........@..
....................
....................
.....@..............
....................
16
17 3 0
14 0 0
6 19 0
3 14 0
12 3 0
5 14 0
4 8 1
2 12 1
2 17 1
12 9 1
10 9 1
7 12 2
9 10 2
17 7 2
10 2 2
15 1 2

5 17 0
3 19 0
6 13 0
14 10 0
14 13 0
5 14 0
19 18 1
19 6 1
3 8 1
0 18 1
0 19 1
8 13 2
10 17 2
5 7 2
10 3 2
13 10 2
