width 20
height 20
....................
@@...............@.@
@@@@..............@@
........@....@....@@
..................@@
...@.@..@......@..@@
....@.@.............
..............@.....
......@@..@.........
....@.......@.....@.
....................
..@......@..........
@..............@....
............@.@..@..
...@.....@.@........
.......@............
.............@...@..
.....@..............
......@..@....@.....
......@.............
16
9 6 0
10 3 0
14 9 0
4 14 0
8 19 0
17 5 0
10 12 1
6 12 1
12 10 1
6 17 1
0 16 1
14 3 2
11 15 2
10 14 2
0 3 2
4 19 2

2 18 0
10 3 0
14 6 0
3 13 0
8 17 0
1 8 0
1 13 1
16 1 1
12 8 1
6 12 1
5 2 1
12 10 2
18 0 2
11 12 2
15 18 2
16 0 2
