width 20
height 20
@@............@@.@@.
@................@..
....................
..@.........@.@.....
......@.@...........
..............@..@..
........@...........
..........@.........
...........@.....@@.
....................
.@...@..............
..@.@.@....@.@......
.........@.........@
...@.@.@...@........
.........@..@.....@@
....@.........@..@@@
.....@..........@@@@
...............@@@@@
............@..@@@@@
..........@....@@@@@
16
7 3 0
11 19 0
19 5 0
12 5 0
3 0 0
7 6 0
1 4 1
11 9 1
2 16 1
4 3 1
6 13 1
12 15 2
12 13 2
3 12 2
15 4 2
9 7 2

19 5 0
12 12 0
5 19 0
18 11 0
4 1 0
0 19 0
19 10 1
10 8 1
8 19 1
8 14 1
9 15 1
7 11 2
13 12 2
10 1 2
5 0 2
4 16 2
