width 20
height 20
...........@........
....@.....@.........
....................
................@...
............@.......
........@.....@.....
..@..@.@.@.@........
....................
..........@.......@.
.....@......@....@..
..............@.....
.........@.......@..
.@.......@@.@...@...
.@....@.............
....................
...............@....
........@...........
...@...........@....
.........@@@@.......
.....@.@@@@@@@......
16
12 3 0
5 5 0
2 17 0
14 3 0
4 6 0
10 14 0
1 8 1
8 7 1
17 7 1
11 14 1
15 7 1
4 2 2
8 2 2
8 18 2
14 2 2
0 16 2

7 0 0
8 3 0
15 3 0
3 15 0
19 19 0
4 3 0
11 3 1
18 3 1
7 12 1
11 14 1
15 7 1
5 5 2
16 18 2
12 7 2
13 2 2
2 9 2
