width 20
height 20
@@@@@@@@@...@..@@@.@
@@@@@@@@@.@...@@@@.@
@@@@@@@@@@..@..@@...
@@@..@@@@.@@@@..@@.@
@.@@..@@@...@.@.....
.....@.@.@.@....@.@@
@.@@........@.@@.@..
@@.@@.@.@@@......@.@
@....@.....@.@.@....
..@.@@@.@.@@.@..@.@@
.@@..@@@@.@@..@.@@@@
.@.@@.@.@.@..@......
...........@.@@.@@.@
.@@.@.@.@.@..@....@.
...@...@.@@@..@.@...
.@.@@@....@..@.@..@.
..@....@.@@@....@..@
.@@@.@@.@@@@.@.@@.@@
@@......@@@@@...@@@@
@..@.@.@@@@@@@.@@@@@
13
2 18 0
5 16 0
8 6 0
9 3 0
19 8 0
17 16 1
5 14 1
13 6 1
13 4 1
15 5 2
15 11 2
15 13 2
14 17 2

9 12 0
13 4 0
1 19 0
1 14 0
15 13 0
19 8 1
15 5 1
3 3 1
5 4 1
7 13 2
16 4 2
2 12 2
17 11 2
