width 20
height 20
.@.@.@.@.@@.@.......
..............@.@@.@
@.@.@@.@.@.@.@.@..@@
@@...@.@.@@......@.@
..@.@@.@.@..@@.@.@..
.@.@@.@.@.@.@@@....@
...@..@...@@..@@.@..
.@..@.@@@.@@@.....@@
@@@....@..@@@@.@.@.@
.@..@.@.@..@.@@.....
..@..@@...@...@@.@.@
.@..@.@.@.@@.@@@@...
...@....@@.@.@@@.@.@
.@.@@.@..........@..
@......@.@.@.@.@...@
@.@.@.@.@.@...@@.@@@
...@@@.....@@@.@..@@
@.@.@.@.@.@@.....@..
.........@...@.@.@.@
@.@.@.@.@..@..@.....
13
13 10 0
6 4 0
14 3 0
6 16 0
17 9 0
16 5 1
0 5 1
18 8 1
5 7 1
11 15 2
2 14 2
11 5 2
4 1 2

11 18 0
16 14 0
5 8 0
2 18 0
13 7 0
0 0 1
17 5 1
10 18 1
15 0 1
3 3 2
19 13 2
9 16 2
1 19 2
