width 20
height 20
..........@.@..@@@@.
@.@.@.@.@.@..@.@@@@.
@@...@..@...@...@...
@@@.@..@.@@.@.@@.@@.
@@@@.@@@............
@@@...@..@.@.@.@@.@@
@@..@@.@..@@@@@..@..
.@@......@.@@...@.@.
...@.@.@......@.....
.@....@@.@.@.@.@@.@.
..@@.@@@@@@@@....@..
.@..@@@@.@.@.@.@..@.
...@...@........@...
.@..@.@@.@@.@.@@..@.
@..@......@@..@.@..@
@@..@.@.@@.@@.@..@..
@.@..@@@@.....@.@.@.
....@@@...@.@......@
@.@..@@@.@..@.@.@.@@
@@..@@@@@@@.@..@....
13
4 8 0
17 16 0
15 8 0
14 2 0
6 2 0
18 14 1
12 1 1
10 16 1
0 17 1
17 5 2
11 8 2
19 2 2
7 2 2

15 6 0
14 7 0
7 7 0
15 14 0
19 9 0
19 0 1
11 3 1
4 7 1
14 17 1
13 12 2
11 8 2
12 9 2
6 6 2
