width 20
height 20
..@...@....@..@@..@@
.@.@@..@@.@.@..@.@@@
......@@......@..@@.
@.@.@.@..@.@@..@..@.
.@@@..@@.@@@@@.@.@..
.@@@@......@.......@
..@@@@.@.@.@@@.@.@@@
.@.@.@..@@@@@...@@@@
.......@@@@@.@.@.@@.
.@.@.@.@@@@.........
.@@.@.@.@@@@@.@@.@.@
...........@..@@..@@
.@@@@@.@.@..@..@.@.@
@.@@.@@.@..@..@.....
..........@@@..@.@.@
.@.@.@@.@..@..@...@@
..@..@.@@@@.@@.@.@@@
.@@@.@.@@.@.......@@
@@@@.@......@.@.@@..
@@@@@@.@.@@@@@.....@
13
1 2 0
13 15 0
10 12 0
7 7 0
14 4 0
3 11 1
17 17 1
7 5 1
13 5 1
4 17 2
5 10 2
7 14 2
9 14 2

18 13 0
9 14 0
11 12 0
3 8 0
16 1 0
4 16 1
2 11 1
14 19 1
1 11 1
16 3 2
4 7 2
7 11 2
14 17 2
