width 20
height 20
.@.@.@@.@.@@....@@@@
.............@.@@.@@
.@.@@@.@.@.@.@..@..@
@@..@@@@@@@..@.@.@..
...@.@.@.@.@@.@....@
.@.@............@.@@
@....@.@@.@.@.@.@@@@
@@.@@...@@@@@@@@..@@
@@@@@@.@@.@.@.@.@.@.
@@@@@@..........@...
@@@@@@@@.@.@.@@...@.
@@@@@@@@@@@...@.@..@
@@@@@@@@@@@@.@@@@.@@
@@@@@@@@@@@@@@@@..@@
@@@@@@@@@@@@@@@@@..@
@@@@@@@@@@@@@@@@@.@@
@@@@@@@@@@@@@@@@@.@@
@@@@@@@@@@@@@@@@@@@@
@@@@@@@@@@@@@@@@@@@@
@@@@@@@@@@@@@@@@@@@@
13
18 9 0
14 2 0
16 4 0
15 5 0
11 5 0
15 2 1
19 9 1
1 1 1
7 5 1
17 2 2
11 6 2
7 1 2
11 1 2

14 1 0
12 0 0
12 3 0
18 4 0
11 1 0
2 4 1
7 7 1
4 6 1
4 4 1
17 4 2
11 8 2
12 11 2
9 1 2
