width 20
height 20
.@@@.@...@@.@@@@@@@@
..@..@.@@@...@@@@@@@
.@.@.@.@@.@.@@@@@@@@
.......@....@@@@@@@@
.@@@@.@@@.@@@@@@@@@@
..@...@@..@@@@@@@@@@
.@.@@@@@@..@.@@@@@@@
...@.@.@..@@.@.@.@@@
@@.......@@.......@.
@..@.@.@...@.@@.@...
@.@.@@@..@..@.@@.@.@
.....@.@..@...@@....
@.@@@..@.@.@@.@@@@.@
@@@@.@...@.@.@.@@...
@.@....@.@........@@
....@@@....@.@.@@.@@
@.@...@@.@.@..@.....
...@@@@..@@.@..@.@.@
@.@@@.@@.....@@@@@..
........@.@@...@@@.@
13
11 17 0
1 1 0
6 0 0
6 19 0
1 12 0
0 0 1
3 19 1
17 13 1
9 7 1
11 14 2
1 11 2
3 11 2
12 7 2

6 2 0
5 3 0
11 8 0
3 14 0
14 15 0
3 11 1
4 13 1
1 1 1
12 13 1
13 17 2
12 7 2
11 14 2
17 14 2
