width 20
height 20
@..@..@@@...........
@@.@.@.@..@@.@.@@.@.
@........@...@@....@
..@@.@.@..@.@...@.@.
@.@@@..@.@@@@@.@@...
@@.@..@.@.@.@.@.@@.@
.....@...........@.@
@.@@..@@.@.@@.@.@.@.
@@@..@@...@.@@......
@@.@.@.@@.....@.@.@.
........@.@.@..@@@@.
@.@.@.@..@@@..@@@.@.
...@.@..@@@.@..@....
.@@@.@@.@.....@@@.@.
.@.@.@.@.@@.@..@...@
.@...........@..@@..
...@@.@.@@@.@..@...@
@.@....@@@@@@@@.@.@@
...@@.@@@@@@@.....@@
.@..@..@@@@@@@.@@..@
13
9 0 0
4 17 0
14 16 0
2 16 0
17 4 0
5 11 1
15 17 1
7 8 1
2 9 1
14 19 2
11 8 2
17 18 2
9 13 2

7 16 0
5 10 0
7 11 0
8 8 0
11 15 0
14 12 1
0 16 1
1 18 1
19 3 1
13 6 2
17 14 2
2 14 2
0 18 2
