width 20
height 20
@@.@@...@.....@...@.
@.....@@.@.@@@.@@...
@@@.@.............@@
..@@@.@@.@.@@.@.@...
.@.@....@@...@.@..@@
...@@.@.@..@@..@@..@
.@...@...@..@.@@..@.
.@@.@.@.@@@....@@.@.
..@......@@@.@..@...
.@.@@.@.@@@@@@.@@@.@
.....@@@@@@@@@..@...
.@.@@.@@@@@@.@.@@@.@
@......@@@@...@@@..@
@@@.@.@@.@.@.@.@@@@@
@..@..............@@
@@..@.@.@.@.@@.@.@@@
@@.@@..@.@..@@@...@@
......@....@@@@.@.@@
@@.@.@@@@@.@@@...@.@
....@@@....@@@@@....
13
2 16 0
11 7 0
4 4 0
17 8 0
17 4 0
12 7 1
7 8 1
9 17 1
15 10 1
13 12 2
15 16 2
12 11 2
6 0 2

5 16 0
6 6 0
7 9 0
10 6 0
9 14 0
3 12 1
5 3 1
12 12 1
11 7 1
0 11 2
5 8 2
8 8 2
5 1 2
