width 20
height 20
@@.@...@@@@..@@@@@@@
@...@@..@@@.@.@@@@@@
.@@..@.@.@.....@@@@@
....@@.....@.@.@@@@@
@.@....@.@..@...@@@@
...@.@.@@..@@@.@@@@@
@.@.@.@..@@@@.@.@@@.
....@.@.@@.@..@..@@.
@.@.........@...@@..
@@@.@@.@.@@.@.@@@.@.
@..@..@.@.@.........
.@...@....@.@.@.@@.@
..@.@.@.@..@@@@@...@
@........@@@..@@.@.@
..@@.@@.@.@..@@.@..@
@.@.@@.@...@..@.@@.@
.......@.@@.@.......
@.@.@@........@.@@.@
...@.@@.@.@.@..@....
.@.....@...@..@..@.@
13
1 7 0
8 3 0
1 16 0
14 10 0
6 3 0
6 1 1
10 2 1
7 3 1
5 8 1
16 19 2
1 1 2
19 8 2
13 6 2

3 19 0
8 3 0
8 6 0
18 8 0
2 10 0
15 19 1
2 5 1
6 4 1
13 9 1
14 3 2
18 16 2
2 0 2
13 11 2
