width 20
height 20
......@....@@@@@@.@.
.@@@.@..@.@.@@@@@...
.@.@@.@@.....@@.@.@.
....@..@@@@.@.@.@..@
.@.@@.@.@.@.......@@
.@.........@@@.@@...
..@.@.@.@.@..@@@.@.@
@..@...@@..@........
@.@.@.@@..@@.@@.@.@.
.@@.@@.@@....@...@..
.........@.@..@@..@.
@.@.@@@.@@@..@@@@..@
@@...@.@@@..@.@..@@.
@@@.@@.@@@@.....@...
@@.....@@..@.@@...@@
@.@.@@@@..@@@.@.@@..
......@.@.@.@...@@.@
@.@.@.......@.@@...@
...@@@.@@@@......@@@
@.@@@..@@@@@.@.@@@@@
13
15 2 0
16 17 0
17 17 0
8 5 0
2 4 0
19 0 1
3 14 1
18 7 1
0 10 1
0 5 2
3 15 2
6 5 2
7 5 2

17 11 0
7 1 0
11 9 0
17 1 0
10 9 0
3 3 1
18 1 1
1 18 1
15 12 1
0 4 2
9 17 2
11 2 2
10 7 2
