width 20
height 20
@.@.@.@.@@@@@@.@@.@@
.........@@@@.......
.@.@.@@.@.@@.@.@.@.@
..@..@@.........@.@@
@.@@.@.@@.@@.@@.@.@@
@.@@@@......@@......
.@.@.@.@.@.@@@@@.@.@
.......@@...@@@@@..@
.@.@@.@@@@.@.@.@@@..
..@..@@@@.......@..@
.@@.@@@@@@.@.@@@@@.@
.@@.@@@@@...@@@@@@@@
.@...@@@.@@..@@@@@@@
@.@.@@@..@.@.@@@@@@@
.....@..@.....@@@@@@
.@@.@.@.@.@@.@@@@@@@
.@..........@@@@@@@@
@@@.@.@.@.@.@@@@@@@@
@@@@@..@@@...@@@@@@@
@@@@..@@@@@.@@@@@@@@
13
7 13 0
1 1 0
6 4 0
17 4 0
10 8 0
3 9 1
3 1 1
15 4 1
7 15 1
17 5 2
7 2 2
3 13 2
9 11 2

12 8 0
1 1 0
7 5 0
14 3 0
14 9 0
9 3 1
4 9 1
3 16 1
7 15 1
12 14 2
7 1 2
0 1 2
5 1 2
