width 20
height 20
.@.@.@.@...@....@.@.
.@.@.....@@..@.@....
.....@.@....@.@..@@.
.@.@..@@@.@....@.@..
..@@@@@@.@@@@.@.@.@.
.@.@.@@@..@.@.......
......@.@.....@.@@@.
.@@.@.@...@@.@.@.@.@
@.@.@@..@@..@.......
......@...@..@.@@.@.
.@@@@@.@@.@.@.@.@@@.
@.@@..........@.....
.....@.@@.@.@@@@.@.@
.@.@..@..@.@@.@.@@..
..@.@@.@...@@.@....@
.@.......@......@.@@
.@.@.@.@.@@.@.@.@...
....@@@@.@@@...@..@.
.@@.@@.@.@@.@@@@.@..
@......@@........@.@
13
1 2 0
8 15 0
1 17 0
15 16 0
2 15 0
19 0 1
19 9 1
2 16 1
9 2 1
12 1 2
11 18 2
5 7 2
13 16 2

0 16 0
17 15 0
11 9 0
4 13 0
0 9 0
9 9 1
11 3 1
3 7 1
5 13 1
18 11 2
19 6 2
5 1 2
11 2 2
