width 20
height 20
.@..@.@@.@@@.@@@@@.@
...@......@@..@@@@..
@@.@.@.@.@@..@@.@.@.
@@...@@....@........
@@@@.@@@.@@@.@.@.@@.
@.@....@.....@@@@@.@
@..@.@@.@@.@..@.@...
.@.@......@@@@...@.@
....@.@.@.@@@..@....
@@.@.@.@....@.@..@@.
........@.@@.@.@.@.@
@@@.@.@.............
.....@..@@.@.@.@.@.@
@.@.@@@.@..@@..@.@@@
@@...@@@..@@@@@@@@@@
@@@.@.@.@@@@@@@@@@@@
..........@@@@@@@@@@
@.@.@.@.@.@@@@@@@@@@
@@..@@@@@@@@@@@@@@@@
@@@@@@@@@@@@@@@@@@@@
13
2 2 0
3 11 0
10 3 0
8 9 0
12 2 0
19 2 1
5 11 1
4 14 1
10 5 1
5 10 2
8 2 2
4 3 2
3 16 2

0 1 0
10 13 0
7 16 0
7 17 0
9 8 0
14 3 1
19 3 1
11 2 1
3 3 1
18 0 2
18 6 2
9 11 2
17 2 2
