width 20
height 20
.@@@@.@.@@@@......@.
..@.......@@@.@.@@@.
.@.@@.@.@..@@@...@..
...@@..@@.@.@.@.@.@.
@@..@.@@............
@..@@@@@@.@.@@.@.@.@
.@..@@@@@@.@..@@@...
...@.@@@.@.@.@.@.@.@
.@..................
..@@@.@@.@.@.@.@.@.@
@@......@...@@@@@@..
@@@.@.@.@@.@@@.@.@.@
.....@..@..@@....@@@
@@@.@@@.@@@@@.@@.@.@
@@@..@...@@@@@......
@@@@.@@.@.@.@.@.@@.@
@@@@@.........@.@...
@@@@@@@@.@@.@..@.@@.
@@@@@@@@@@@@@.@.....
@@@@@@@@@@@.....@.@.
13
4 8 0
14 4 0
19 17 0
17 3 0
16 8 0
9 1 1
19 0 1
9 2 1
18 5 1
12 19 2
8 17 2
19 19 2
17 18 2

6 8 0
1 12 0
9 2 0
5 4 0
13 18 0
16 12 1
7 0 1
14 19 1
18 14 1
14 12 2
13 15 2
8 17 2
6 1 2
