width 20
height 20
@@@..@@@@@.@@@@@@@@@
@.@.@.@@@@..@@@@@@@@
........@@.@@@@@@@@@
.@.@.@.@....@@@@@@@@
..@@@....@.@@@@@@@@@
.@@@.@@@..@@@@@@@@@@
...@.....@.@@@@@@@@@
.@@..@.@@...@@@@@@@@
..@@..@@@@.@.@@@@@@@
.@@..@.@@....@@@@@@@
.@.@.....@.@..@.@@.@
@....@.@.@@..@..@...
@@.@@@@.....@.@..@.@
...@.@.@@@.@...@....
.@......@.@..@...@.@
.@@@@.@....@..@@.@..
.....@@@@@...@@@@..@
.@.@..@.@..@@@.@.@..
@.@@.@....@@@......@
.....@@.@.@@..@@.@.@
13
7 12 0
0 16 0
18 19 0
14 17 0
6 7 0
11 12 1
18 10 1
12 16 1
3 14 1
4 7 2
14 18 2
6 6 2
7 17 2

8 3 0
2 16 0
7 4 0
18 12 0
14 13 0
9 3 1
15 12 1
0 15 1
5 2 1
12 8 2
2 12 2
9 18 2
19 17 2
