width 20
height 20
@@@@..@..@.........@
@@@@.@.@.@@.@@.@.@..
@@@.........@.@...@@
@@.@@.@.@.@.@..@.@@@
.......@...@.@..@@@@
.@@.@.@@@.@@...@@@@@
...@.@@@@@@@@.@@@@@@
.@.@.......@...@@@@@
@..@.@@.@.@.@.@.@.@@
@@.....@@...@.@....@
@@.@.@@@..@...@.@.@@
@@@....@@@@@.@@@...@
@@@@.@..@.@@@.@.@.@@
@@@@@..@...........@
@@@@@.@.@@.@.@@.@.@@
@@@@@......@.@@@...@
@@@@@.@.@.@@..@.@.@@
@@@@@@...@...@.....@
@@@@@@@.@@@.@.@.@.@@
@@@@@@@.@@@@....@..@
13
9 15 0
7 2 0
1 8 0
16 15 0
9 13 0
4 9 1
7 7 1
12 5 1
17 0 1
10 7 2
10 14 2
17 15 2
0 7 2

4 10 0
0 4 0
18 9 0
9 7 0
11 1 0
17 15 1
1 6 1
15 19 1
13 5 1
10 0 2
10 14 2
18 0 2
13 9 2
