width 20
height 20
@@@.@@..........@...
.@..@@@@.@.@.@.@.@.@
...@@@.@..@.@.......
.@.......@...@@.@@.@
..@.@@.@@.@.@.@@.@.@
.@@@.@@@............
@@@...@@.@.@.@.@.@.@
@@@.@.@@.@@...@@..@@
@....@....@@.@...@.@
@@@.@@@.@...@@@.@...
@....@@@..@.@.@@.@.@
@.@@..@.@.@@.......@
..@..@.......@.@.@@@
@..@@..@@@.@.@@...@@
..@...@@@...@@@@.@.@
@...@@.@.@.@@@@.....
..@.@@...@@@@@@@.@@.
@..@@.@@.@.@@@@@@...
@.@.@.@.....@@@@@@.@
........@.@@@@@@@@@@
13
18 3 0
1 2 0
17 11 0
10 3 0
14 11 0
18 0 1
18 1 1
16 16 1
13 7 1
2 13 2
16 6 2
8 6 2
9 2 2

17 0 0
9 11 0
9 5 0
2 19 0
4 19 0
1 2 1
3 3 1
16 13 1
4 12 1
18 5 2
8 12 2
18 9 2
3 15 2
