width 20
height 20
..@@.....@...@.@@@..
.@.@.@.@@@.@.@....@.
......@@@@@....@@.@.
.@.@.@.@@@@.@@.@.@..
.@@@....@@..@......@
....@.@.@.@@..@.@@.@
.@.@@@.......@.@@...
@.@@@@@.@@.@.@.@.@.@
@.@@@@....@.@.......
@..@@@@.@.@..@.@.@.@
@.@@@@@@....@@@@@...
..@@@@@@@.@@@@@@.@.@
.@.@@@@@.....@@.....
....@@@.@@.@.@.@.@.@
@@.@.@....@.@.....@@
@.....@.@.....@.@..@
.@.@.@.@@.@@.@.@..@.
...@.....@@@....@...
.@..@.@@.....@.@..@.
..@..@@@@.@.@..@.@..
13
11 10 0
0 1 0
2 2 0
6 8 0
12 17 0
10 15 1
19 16 1
19 17 1
5 18 1
17 14 2
9 18 2
16 16 2
13 5 2

0 18 0
13 15 0
2 17 0
6 16 0
0 0 0
10 7 1
4 15 1
3 5 1
14 9 1
19 2 2
5 2 2
16 3 2
1 5 2
