width 20
height 20
....@@@@.@.@.@@@@@@@
.@@@.@@........@@@@@
.@.@.@@@.@.@@@..@@..
...@......@@...@@..@
.@...@.@.@@@@.@@@@..
..@@.@@..@@@@@@@@@@.
.@..@@@@..@@@.@@@...
...@.@.@.@@@@..@..@@
.@......@@@@..@.@..@
@..@.@.@@@@@@.....@@
@@..@@@@@@@@..@.@..@
@..@.@.@@.@.@@@@..@.
.@...........@@.@...
.@@.@.@.@.@.@.....@@
..@..@@@.@@...@.@...
.@.@.@@..@@@.@.@.@.@
........@@@@@..@..@@
@.@@.@.@@@@@@@...@@@
@@@@@@.@.@@.@.@.@.@@
@@@@@..............@
13
18 6 0
1 9 0
12 1 0
17 12 0
6 19 0
4 17 1
15 13 1
17 3 1
18 4 1
7 8 2
3 10 2
15 9 2
3 16 2

11 13 0
0 0 0
17 14 0
5 13 0
4 14 0
18 2 1
14 17 1
2 15 1
15 19 1
4 2 2
3 8 2
17 6 2
13 4 2
