width 20
height 20
..@...@@@.@@@..@@@@@
.@..@@@@...@@@.@@@@@
..@...@.@@..@..@@@@.
@...@@@..@.@@.@.@@..
@.@@@...@..@......@.
......@...@.@.@.@...
@.@.@@@.@....@..@@@@
...@@@@@..@.@.@.@...
@.@.@@.@@@@@..@..@@.
.....@.@.@@.@.@.@.@.
.@.@................
.@@.@.@.@.@.@.@.@@.@
.@@..@.@@@@@.@.@...@
@..@......@......@.@
.@...@.@.@@@@.@@..@@
...@@.@.@.@...@..@@.
.@@.........@.@@.@..
...@.@.@.@.@..@@.@@.
.@....@@@@.@.@@.....
.@.@.@@@@@..@@@@.@.@
13
1 6 0
16 18 0
9 15 0
1 9 0
16 16 0
9 16 1
10 18 1
13 2 1
2 10 1
19 16 2
9 6 2
8 3 2
14 6 2

6 10 0
4 13 0
14 4 0
19 16 0
16 16 0
17 4 1
16 14 1
10 2 1
8 7 1
9 1 2
1 4 2
3 12 2
15 10 2
