width 20
height 20
@@@.....@@...@@@@.@.
..@.@@.@..@.@.@.....
.@.@.@.@.@......@.@.
.......@.@.@@.@.@..@
@@.@.@....@@..@@.@..
....@@@.@....@@...@@
@.@@@@.@.@.@..@.@...
..........@.@....@.@
@.@.@.@@.@...@@.@..@
.@@..@@....@@..@.@.@
....@@@@.@@@.@.@....
@.@..@@...@@...@.@@.
@@..@@@@.@..@@..@@@.
@@@..@...@@.@..@@@@@
@@@.@@@@.....@.@@@@@
@@@@@@@@.@@.@@.@.@@@
@@@@@@@@@.........@@
@@@@@@@@..@.@@.@.@.@
@@@@@@@@@..@@@@.....
@@@@@@@...@@@@@.@.@@
13
19 1 0
15 19 0
15 2 0
13 7 0
14 10 0
3 5 1
19 18 1
16 10 1
15 8 1
3 3 2
10 3 2
16 11 2
8 15 2

3 7 0
2 3 0
15 16 0
8 13 0
13 2 0
1 3 1
16 1 1
15 18 1
12 4 1
3 3 2
8 2 2
9 16 2
16 9 2
