width 20
height 20
...@........@.@.@..@
@@...@.@.@@.....@@..
...@.@.@@@..@.@....@
.@.@@.@.@.@.@@@.@.@.
@.@.@........@.@@...
@.....@.@.@@.@....@.
@.@.@@...@.@@@.@.@..
...@@@.@@@..@.@.@.@.
@.@.@@@....@@.@.....
.....@..@@......@.@.
@@.@..@@@@.@.@.@..@.
...@@.@@@@@@@@@.@@.@
.@.@...@@@.@.@......
@.@.@.@.@......@.@.@
..........@.@@.@@...
@.@.@.@.@@@.@@@.@@.@
...@@@@@@.@..@...@@@
.@....@@@...@@.@@.@@
@.@.@@@@..@........@
@.....@@@.@.@.@.@@@@
13
19 5 0
9 8 0
16 6 0
3 5 0
4 9 0
9 4 1
14 6 1
9 3 1
3 19 1
1 5 2
9 18 2
4 0 2
7 8 2

16 18 0
5 4 0
13 7 0
18 8 0
7 9 0
17 4 1
4 14 1
1 9 1
9 14 1
4 17 2
10 4 2
12 13 2
6 0 2
