width 20
height 20
@@@@@@@..@...@@@...@
@@@@@@@@..@.@.@@.@@.
@@@@@@@..@........@.
@@@@@@.@.@.@.@.@.@..
@@@.@......@@@@@.@@.
@@...@.@.@.@.@@.....
@.@.@@..@.@..@..@@.@
.......@....@.@..@..
@.@.@.@.@.@@....@.@@
@..@@.....@.@.@.....
..@.@.@@@@....@@.@@.
@....@@@@@@.@@@@@...
@@.@...@@....@.@@.@.
.@@..@.@..@.@...@@@.
..@@..@@@.@@..@.@...
.@.@.@.......@.@..@.
....@.@.@.@@.@...@@@
@.@......@.@@..@.@..
@@..@.@.@....@.@@.@.
@@@..@...@@@........
13
0 10 0
3 13 0
9 4 0
8 9 0
8 13 0
12 10 1
12 14 1
4 19 1
0 15 1
7 18 2
6 15 2
1 14 2
17 19 2

11 10 0
6 6 0
8 15 0
8 9 0
9 13 0
6 13 1
14 12 1
11 6 1
17 11 1
10 15 2
15 16 2
11 0 2
17 14 2
