width 20
height 20
..@.......@@@....@@@
.@@.@.@.@@.@..@.@@@@
....@@.......@@..@@@
@.@...@@.@.@@...@@@@
@@..@.@@@..@@@.@@@@@
...@@@.@.@....@@@@@@
.@@.@@.....@.@@@@@@@
.@@....@.@.@.@@@..@@
.@..@.@.@.@.@.@@@.@@
@.@.@@.........@...@
......@.@.@.@.@.@@..
.@.@@...@@@@....@@.@
..@@.@@.@.@.@.@.@...
@..@.........@.@@@.@
@.@@@.@.@@.@...@....
@@@@@@..@.@..@.@@@.@
@@@@@@@....@@.......
@@@@@@@@@@@..@@.@.@.
@@@@@@@@@@@@...@...@
@@@@@@@@@@@@.@...@..
13
7 2 0
9 8 0
19 17 0
15 2 0
18 10 0
2 10 1
12 14 1
7 15 1
5 8 1
8 13 2
0 7 2
12 19 2
17 18 2

1 12 0
19 17 0
3 2 0
16 7 0
0 7 0
8 13 1
9 12 1
15 2 1
5 1 1
11 8 2
7 6 2
6 0 2
12 1 2
