width 20
height 20
@.@@@@@@@@..........
..@@.@.@@@.@@.@@.@.@
@...........@@..@...
..@.@.@.@@.@.@@..@.@
@..@.@.@.@.@.@.@....
..@..@.@...@.....@@@
@...@...@.@@@.@.@@@@
@@.@.@.@@.@....@@@@@
@........@@@.@..@.@@
.@.@.@.@....@..@@..@
..@@@@.@@.@..@.@..@.
@.@@..@@@@..@...@...
...@@..@.@@..@.@@.@.
@.@.@.@@.@.@..@@@@..
.............@.@...@
.@.@.@.@.@.@....@@..
..@..@.@..@..@.@...@
.@@@.@@..@..@..@.@..
@@@....@@.@..@....@.
@@@@.@.....@@@.@.@@@
13
6 5 0
1 8 0
16 16 0
12 12 0
7 17 0
12 16 1
3 8 1
13 0 1
9 10 1
3 16 2
5 8 2
12 18 2
19 10 2

10 5 0
8 9 0
14 16 0
3 3 0
9 10 0
8 5 1
14 9 1
2 2 1
2 15 1
2 6 2
13 13 2
18 2 2
16 17 2
