width 20
height 20
@.@.@.@@.@.@..@@@@@.
.............@@@@@@.
.@@.@.@@@.@.@.@.@.@.
..@@.@.@@@........@.
.@.@....@@@.@.@.@...
....@@.@@@@@@@...@.@
.@@.@...@....@.@.@@@
@@@..@.@.@@@..@.....
@@..@@.......@@@@.@@
@@.@.@@.@@@@..@....@
......@.@.@.@...@.@@
.@.@.@.@......@.@.@@
..@@@...@@@.@..@....
.@.@.@.@.@.@..@@@.@.
............@.@@@..@
.@.@.@.@.@.@.@.@..@@
..@...@.@@......@@@@
.@.@@.@.@.@.@@.@@@@@
....@...@.@@.@@.@@@@
.@.@@.@..........@@@
13
0 4 0
13 12 0
3 18 0
7 14 0
8 8 0
17 8 1
5 0 1
9 2 1
10 0 1
4 10 2
1 12 2
6 4 2
13 2 2

8 14 0
0 3 0
0 15 0
15 3 0
5 19 0
6 4 1
11 4 1
0 16 1
14 17 1
6 6 2
7 9 2
19 0 2
10 19 2
