width 20
height 20
@@..@....@.@........
...@@@.@@....@@@.@.@
.@@......@.@.@....@@
.@..@.@.@@@..@@.@@@@
...@.@.@.@.@..@@@..@
.@..........@.....@@
@..@.@.@.@@...@.@..@
@.@@@.@@@@@@.@@@..@.
...@.....@@@@@..@@@.
@.@..@.@...@...@....
@.@@@.@.@.@.@@.@.@@.
...............@@.@.
@.@@.@.@@.@@.@......
..@@..@..@@.@..@@.@.
@.@..@@@......@@@@@@
...@..@..@.@@..@@@@@
@.@@@@.@.@.@@@..@@@@
.@.@.@.@..@@@@.@.@@@
.........@@@.@.....@
@.@.@@.@.@@....@.@..
13
0 11 0
12 19 0
2 15 0
13 6 0
17 5 0
7 8 1
13 9 1
18 9 1
4 2 1
12 1 2
12 9 2
1 16 2
17 7 2

6 19 0
12 19 0
18 1 0
7 8 0
0 11 0
5 18 1
14 9 1
14 13 1
6 5 1
6 17 2
1 9 2
1 12 2
1 18 2
