width 20
height 20
@@@@@@@.@..@..@@@@@@
@..@@@@.@.@.@.@@@@@@
..@.@@..@......@@@@@
@.....@...@.@.@.@@@@
@@.@@..@@..@@...@@@@
@@.@..@...@@..@@@@@@
..@.@...@.@@@.@@@@@@
@.....@@.@.@.@.@@@@@
..@@@@.@...@....@@@@
.@.@.@...@...@.@@@@@
...@...@@.@@.@@@@@@@
@@...@......@..@@@@@
@@@@..@@.@@@.@..@@@@
.@@..@@.@@@@...@@@@@
....@@...@.@.@@.@@@@
@.@..@@.@........@@@
...@.....@@.@@@.@.@.
@.@.@.@.@.@.@.......
.....@@....@..@.@.@.
.@.@@...@@...@...@..
13
0 10 0
9 3 0
1 8 0
9 0 0
15 8 0
4 12 1
7 13 1
15 12 1
7 5 1
2 19 2
6 10 2
19 19 2
9 6 2

3 11 0
14 13 0
16 15 0
13 17 0
5 5 0
2 3 1
7 16 1
14 4 1
6 11 1
10 18 2
8 11 2
11 9 2
12 10 2
