width 20
height 20
@.@.@@.....@......@@
......@.@.@..@.@@.@@
.@@@.@.@...@..@....@
@.......@.@.@@.@@@.@
@@@@.@@............@
@@@@@...@@.@.@.@.@@@
@@@@.@@.@.@@@.@..@@@
@@@@.......@....@.@.
@@@..@.@@@@@@.@.....
@@.@..@.@@@@...@.@.@
@@...@@.@.@..@@@@...
@..@.@......@@@@.@@.
..@.@..@.@.@@@@.....
@...@@..@@.@@@@.@.@.
@@@.@..@@@@@@@@.@..@
@@@@.@.@.@.@@@.@..@@
@@@@........@@...@.@
@@@@@.@@@.@@@@.@....
@@@@....@...@..@.@@.
@@@@.@.@@.@.@@.@...@
13
2 10 0
13 2 0
16 6 0
11 4 0
1 1 0
5 9 1
10 16 1
16 5 1
13 6 1
5 1 2
19 18 2
18 16 2
4 15 2

11 19 0
17 4 0
7 1 0
9 7 0
14 9 0
0 2 1
7 9 1
4 16 1
17 17 1
11 11 2
6 2 2
1 12 2
17 10 2
