width 20
height 20
@.@.@.@@@@@.@@@@@@@@
@......@@@....@@@@@@
@@@.@.@.@@@@@..@.@@@
@@@@..........@...@@
@.@.@.@@.@.@@..@.@.@
.....@....@.@@......
.@.@..@@.@.....@@.@.
@.@..@@.@.@.@.@@@@..
@.@@........@..@@@@.
..@.@@@@.@@@@@@@@@@@
@.@............@@@@@
....@.@.@@.@@.@@@@@@
.@@..@..@...@@@@@@@@
..@.@@@..@.@.@@@@@@@
@.@@@@@@@@....@@@@@@
@@@@@@@@.@.@.@..@@@@
@@@@@@@@..@..@.@@@@@
@@@@@@@@@..@.....@@@
@@@@@@@@@.@.@.@@@@@@
@@@@@@@@...........@
13
9 19 0
10 6 0
18 7 0
11 8 0
17 5 0
0 5 1
6 1 1
3 9 1
7 2 1
1 10 2
5 6 2
3 13 2
11 5 2

9 19 0
1 13 0
18 5 0
10 6 0
12 3 0
6 3 1
7 10 1
0 9 1
1 7 1
3 12 2
19 8 2
1 0 2
12 15 2
