width 20
height 20
...@..@@.@.@@@@..@@@
@.@.@........@..@.@@
......@.@@.@@@@...@@
@.@.@.@@@...@@@@@.@@
...@@@..@@.@.@@@..@@
@@.@..@.@.......@..@
@@..@....@.@@.@...@.
@@@..@@.@.@@.@@@@...
.@..@........@@.@.@.
...@.@.@.@@.@@.....@
.@.....@@.@.@.@.@@..
@.@@@@@@....@....@@.
.........@.@..@.@..@
.@.@.@.@.@@.@.@@.@..
..@..@.@@......@.@.@
.@.@@...@@.@.@.@...@
....@@@.@@.@@.@..@.@
.@.@@@@@@.....@.@.@.
.@@.@@@@@@@.@.......
.....@@@.....@@@.@@.
13
11 8 0
2 12 0
4 13 0
3 16 0
0 12 0
9 8 1
7 2 1
14 5 1
7 4 1
8 0 2
17 4 2
18 7 2
8 19 2

0 8 0
3 1 0
0 16 0
10 1 0
9 14 0
9 17 1
11 13 1
10 11 1
2 0 1
2 19 2
5 10 2
11 8 2
13 18 2
