width 20
height 20
@@@@@@.@.....@.@@@@.
@@@@@....@@.@@..@...
@@@@@@@.@....@.@.@@.
@@@@@.@@@@.@@.......
@@@@..@@@..@@.@@@.@.
@@@..@.@.@.@.@.@..@.
@@@@............@.@@
.@...@@@.@.@@.@....@
.@@@...@@.@.@@.@.@..
..@..@@@@.@..@..@@@.
.@..@@....@.@.@.....
...@.@@.@.@.....@.@.
@@.@.@..@.@.@@@..@@@
@..@..@@...@....@.@.
.@...@.@@@.@@.@.....
...@........@..@.@@.
.@.@.@@.@@@.@@@@@...
..@....@@@...@..@@@.
@..@@@@.@.@@.@.@@.@.
@@.@...........@....
13
16 12 0
19 13 0
1 15 0
8 15 0
18 1 0
14 19 1
10 14 1
6 14 1
0 17 1
19 8 2
10 3 2
4 15 2
18 16 2

1 15 0
13 4 0
15 7 0
0 15 0
7 18 0
3 9 1
16 19 1
6 0 1
19 19 1
18 8 2
2 13 2
4 6 2
10 2 2
