width 20
height 20
....................
.@.@@.@@.@.@.@.@.@.@
..@..@@@@.@@@.@...@.
@..@..@.@.@.@.@.@...
@.@.@.@.@.......@.@.
......@...@.@.@..@..
@.@@@..@@@..@@@@..@@
@@@@.@...@@...@..@@@
..@....@@@@@.@..@@@@
.@@@.@.@.@.@@@@.@@@@
..@...@..@...@@@@@@@
.@.@.@@@.@.@.@@@@@@@
...........@@@@@@@@@
@.@.@@.@.@.@@@@@@@@@
..@@..@.@.@.@@@@@@@@
@.@.@........@@@@@@@
......@.@.@.@@@@@@@@
@.@.@..@@..@@@@@@@@@
...@..@@..@@@@@@@@@@
@.@@@@@@@...@@@@@@@@
13
9 12 0
8 0 0
16 0 0
7 5 0
10 15 0
2 16 1
5 17 1
3 12 1
1 4 1
11 5 2
4 0 2
3 4 2
7 3 2

16 6 0
10 19 0
1 12 0
3 5 0
7 7 0
4 0 1
15 3 1
12 15 1
5 1 1
0 10 2
5 0 2
6 6 2
5 6 2
