width 20
height 20
@@@@@@@@@.@@@@.....@
@@@@@@@@@..@@@.@.@.@
@@@@@@@@@.@.@.@.@...
@@@@@@@@.........@.@
@@@@@@@@.@@.@.@.@...
.@.@@.@.@.@.@@....@.
.@.@........@@@.@@..
...@.@@.@.@@@@.@@.@.
.@.@..@@@@@.@.......
..@..@.......@.@.@@.
.@.@.@@.@@.@..@@...@
.....@@@....@....@.@
.@.@@@@@@.@@@@@.@...
@..@.@@@..@.@@.@@@.@
@@@...@@@.......@@@@
@@..@@.@..@.@.@.@@@.
@@@.....@..@@@...@..
@@@@.@.@.@@.@.@.@@.@
@@@@.@..............
@@@@@..@.@@.@.@.@.@.
13
4 9 0
9 13 0
8 3 0
14 7 0
18 17 0
19 16 1
3 9 1
17 19 1
10 16 1
11 17 2
19 12 2
1 7 2
0 12 2

10 11 0
14 0 0
16 11 0
4 17 0
19 6 0
10 14 1
15 4 1
16 0 1
9 16 1
12 10 2
11 9 2
4 11 2
18 1 2
