width 20
height 20
.@.@@.@@@.@@@......@
.......@@..@@.@.@@..
@@.@.@.@..@.@@@.@..@
@..@@@@.@....@@@.@..
.@.@.@....@@@@@....@
.......@@..@.@.@.@@@
@@@.@@@...@....@..@.
@@@@.@@@@..@.@...@..
@@@@...@.@...@.@@.@.
@@@@.@.....@.@.@....
..@...@@.@@@.@@.@.@.
.@.@.@@.@..........@
.........@.@@@@@.@..
@@.@.@.@@.@.@..@@..@
@@@@@...@....@.@@@..
@@@@@@.@@@.@...@...@
@@@@@@.@@@@..@@@@@.@
@@@@@.@.@@.@.@.@.@..
@@@@...............@
@@@@@.@@@.@.@.@@.@.@
13
17 4 0
16 4 0
17 13 0
17 11 0
17 6 0
0 5 1
10 8 1
14 13 1
14 14 1
17 2 2
9 18 2
1 1 2
13 1 2

18 0 0
17 6 0
18 12 0
7 17 0
4 18 0
6 16 1
11 16 1
18 14 1
18 9 1
16 5 2
13 1 2
15 0 2
9 5 2
