width 20
height 20
...@.@.@.@..@....@.@
.@.......@@...@.@@.@
@..@@.@@@.@@.@.@.@..
.@..@.@@...@.......@
...@.@.@@.@.@.@.@@..
.@@............@@.@.
....@.@@@.@.@.@.....
.@@.@....@...@@@@.@@
@@.@@@.@.@.@.@@@@...
@......@.@@@.@....@@
@@.@.@..@.@@@@@.@.@.
....@@.@...@...@....
@@.@@@@.@.@.@.@.@@@.
@.@@@@..............
...@@.@.@@.@@@.@.@@.
.@....@@@.@..@..@@..
.@@.@.@...@.@.@@@.@.
...@@@..@...........
.@.....@..@.@@.@@.@.
@..@@.@@@..@@@@@..@.
13
9 11 0
10 19 0
5 14 0
11 0 0
2 17 0
16 11 1
9 3 1
12 5 1
2 3 1
18 2 2
14 3 2
15 15 2
12 7 2

18 6 0
12 15 0
9 15 0
3 15 0
19 11 0
15 12 1
12 3 1
1 17 1
17 8 1
5 7 2
6 18 2
8 7 2
5 14 2
