width 20
height 20
@@@@@@@@@@..@.@@..@@
@@@@@@@@@.@......@.@
@.@@@.@.....@@.@....
..@@....@@@@..@..@@@
@..@@.@@.....@.@....
..@@..@..@.@.....@.@
@..@@.@@.@@.@.@@..@@
.@..@...@@...@.@.@.@
...@..@@@.@@.......@
.@.@@..@....@@.@.@..
@@....@..@@.....@..@
..@@.@@@.@..@.@.@@@@
.@.@@.@.@.@..@..@@@@
............@.@...@@
.@.@@.@.@@.@@..@.@@@
@...@@@@.@@..@...@@@
@@.@..@....@..@@..@@
@@@..@.@.@@.@.@.@..@
@@@@..............@.
@@@@@.@.@.@.@.@.@...
13
8 13 0
18 1 0
5 14 0
13 8 0
15 17 0
13 3 1
10 16 1
14 8 1
2 15 1
1 15 2
17 0 2
10 4 2
15 12 2

1 3 0
11 15 0
2 4 0
3 7 0
9 18 0
17 8 1
4 8 1
12 15 1
2 10 1
7 7 2
1 4 2
2 12 2
14 7 2
