width 20
height 20
@@@@@.@.@.@@.@.@@...
@@@@.......@....@@.@
@@@@@.@.@.@.@@.@.@.@
@@@@.@@@............
@@@@..@@@.@.@@.@@@.@
@@@..@@@@..@.@@@@@.@
.@.@.@.@.@@@..@@@...
.@.@......@@.@.@@@.@
.....@.@.@@....@@...
@.@.@@@.....@.@@@@.@
@@...@@@.@.@@..@@...
@@@.@.....@...@.@.@@
@@...@@.@@@@@......@
@.@.@.@.@@@@@.@.@@..
.......@@@@@.@..@..@
@@.@@.@@@@@....@..@@
@@@@@.@@@@@@@.@@.@.@
@@@@@@@@@.@...@.....
@@@@@@@@....@.@@.@.@
@@@@@@@@@.@..@...@.@
13
14 8 0
13 6 0
15 19 0
0 14 0
9 7 0
14 15 1
7 0 1
3 13 1
12 8 1
12 7 2
4 5 2
17 10 2
15 3 2

14 12 0
5 2 0
13 6 0
11 8 0
9 7 0
18 6 1
1 8 1
17 12 1
12 8 1
4 5 2
11 17 2
19 0 2
2 15 2
