width 20
height 20
.@.@@.@@.@@@@@@@@@@@
....@.@...@@@@@@@@@@
.@.@...@@.@@@@@@@@@@
..@..@.....@@@@@@@@@
.@.@@..@.@..@@@@@@@@
...@.@..@..@@@@@@@@@
.@...@.@.@.@.@.@@@@@
..@.@.....@......@@@
.@@@..@@.@@.@.@.@@@@
....@.@.@.@..@@...@.
.@.@....@.@.@...@...
@....@@......@@.@.@.
.@.@@.@@.@.@@....@@.
......@@@.@...@.@...
.@.@.@@@....@..@..@.
@.@...@..@@..@.@@.@@
...@.@@@@..@..@@@...
.@...@@@..@.@@.@@.@@
..@.@@@@@..........@
.@@@@@@@@@.@@.@.@.@@
13
1 1 0
4 10 0
8 8 0
0 7 0
0 19 0
0 0 1
12 7 1
7 7 1
4 11 1
10 16 2
16 7 2
3 9 2
4 3 2

4 11 0
14 18 0
9 18 0
0 19 0
5 13 0
13 14 1
14 6 1
3 1 1
10 14 1
1 18 2
13 16 2
0 1 2
0 8 2
