width 20
height 20
@@@.................
@@@@.@.@.@.@.@.@.@.@
@@@...@...@@..@@@..@
@@@@.@@@.@@@.@@@@@..
@@@@@@@@@.....@@@.@.
.@@@@@@.@@@@.@@@....
..@.@....@......@@@.
@.@..@@.@.@.@@@...@@
@...@......@@@..@...
@.@@.@.@@.@@@.@..@.@
.......@...@@...@@@@
@@.@.@.@.@....@.@@@@
@@@@@..@@.@@.@...@@@
@@.@.@......@@@@..@@
@@.@...@.@@..@.@.@@@
.....@.@@@..@@....@@
.@.@..@@..@..@.@.@@@
..@@.@@@@...@.@@..@@
@..@@@@@@@@@@....@@@
@@..@@@@@@@@@@.@.@@@
13
8 6 0
8 13 0
15 9 0
4 13 0
3 2 0
14 6 1
13 17 1
16 12 1
12 0 1
4 17 2
18 2 2
16 19 2
10 6 2

7 6 0
17 5 0
0 17 0
14 10 0
4 17 0
9 8 1
15 9 1
16 18 1
13 10 1
3 19 2
13 17 2
16 19 2
19 5 2
