width 20
height 20
..@.@@.@.@.@...@...@
@...........@@.@@.@@
..@.@@.@.@.@.@..@.@@
@..@..@.@@...@.@...@
..@@.@...@@.@..@.@@.
@......@...@.@.@....
@.@.@.@@.@.@.@.@.@@.
.@@@@@..@......@.@..
..@.@.@..@.@.@....@.
.@......@...@@.@.@..
.@.@.@.@.@.@.@..@..@
...@@........@.@.@..
.@.@..@@.@.@@..@.@@.
..@.@...@.@@@@.....@
.@....@...@@.@.@.@..
@.@@.@@.@@@@..@.@@.@
..@.@.@.@@@..@......
@........@.@...@.@.@
@@.@.@.@@....@.@@@..
....@..@@@@@..@@@@@.
13
14 18 0
12 5 0
8 0 0
8 8 0
12 8 0
7 16 1
14 6 1
4 1 1
7 3 1
15 15 2
14 3 2
14 9 2
13 12 2

14 17 0
16 7 0
9 7 0
3 8 0
8 1 0
16 3 1
2 10 1
11 7 1
6 18 1
6 9 2
10 3 2
10 7 2
13 12 2
