width 20
height 20
@......@@@.@@@.@..@@
.@@@.@..@...@...@...
..@...@@@@.@.@.@@.@.
.@@@.@@@@..........@
.......@..@.@.@.@.@@
.@.@.@..@.@@@.@.@...
..@..@.@.@.@.@.@.@.@
@.@.@...............
@..@.@.@@.@.@@@@.@.@
@@@..@..@@@@@.....@@
@@.@.@.@@.@..@.@.@@.
@.....@@....@...@@..
@@.@.@.@.@@..@@...@.
...@....@...@@@.@.@.
@@..@@.@.@.@.@.@..@.
@.@.@............@@.
.....@@@.@.@.@.@.@@.
@.@.@.....@..@@@@...
...@@@.@.@@@...@..@.
@.@@@...@@@@.@...@@.
13
17 3 0
2 18 0
8 17 0
15 11 0
8 15 0
3 0 1
3 9 1
2 12 1
14 14 1
9 15 2
6 4 2
5 7 2
8 4 2

13 3 0
19 16 0
2 5 0
15 12 0
10 3 0
12 19 1
19 17 1
3 16 1
19 14 1
10 15 2
1 18 2
13 15 2
9 8 2
