width 20
height 20
@..@..@@@.......@...
@@...@@@..@@.@.@..@.
@..@..@.@..@@..@.@.@
@@..@@....@@.@......
@@.@.@.@@.@....@.@.@
@........@.@.@..@@..
@.@.@@.@...@@@.@@.@.
...@@@..@@.@..@@....
.@@@@.@@@....@@@@.@.
.@@.....@@.@.@.@...@
...@@.@.@.@.....@@.@
@.@...@....@.@@.@@@.
@@..@..@.@.@.@.@.@..
@@@.@.@@..@@.......@
.@@.@..@.@@@@.@.@@.@
.....@..@@@@.@.@@...
@.@.@..@.......@.@.@
...@..@..@.@.@......
.@..@.@@..@..@@@@.@@
..@@.....@@@.....@@@
13
10 12 0
18 3 0
0 18 0
8 5 0
7 5 0
6 6 1
13 10 1
18 9 1
15 10 1
18 0 2
12 16 2
5 10 2
4 15 2

12 11 0
15 19 0
12 0 0
5 12 0
10 2 0
19 0 1
17 9 1
13 13 1
18 7 1
8 14 2
7 7 2
18 15 2
12 17 2
