width 20
height 20
@@@@@@@.@@@.@@.@@@..
@@@.@@...@......@..@
@@...@@.@..@.@.@.@..
@@@.@.@.@@..@......@
...........@.@.@.@..
@.@@.@.@.@....@@@@.@
@...@.@...@.@..@....
..@...@@@..@@.@@@.@.
@..@.@..@.@..@.@...@
.@@.@.@.@@.@.....@..
.........@.@.@@.@@.@
.@@.@.@@.......@....
.@.@@.@.@.@@.@@@@@.@
...@.@...@@@@@@@@@@@
.@....@.@.@@@@@@@@@@
@@@.@.......@@@@@@@@
@@@.@.@.@.@@@@@@@@@@
@..@...@@@@@@@@@@@@@
@.@.@.@.@.@@@@@@@@@@
...........@@@@@@@@@
13
11 15 0
18 4 0
6 5 0
8 1 0
8 10 0
13 5 1
13 11 1
14 4 1
3 1 1
19 0 2
7 14 2
7 15 2
6 8 2

12 9 0
1 4 0
19 7 0
5 4 0
10 1 0
8 15 1
2 2 1
16 6 1
6 10 1
8 19 2
0 13 2
12 2 2
15 10 2
