width 20
height 20
..@...@..@@@@..@..@@
.@.@@.@.@.@@.@.@.@.@
...................@
@.@@.@.@.@.@@@.@@@..
@@....@@@@@...@@@..@
...@.@.@.@.@@..@.@..
@@..@@...@.@..@....@
.@.@@.@.@....@@@.@@.
..........@.@@@.....
.@.@.@.@.@@@@.@.@@@.
@.@.@.@........@@...
.......@.@.@.@@.@@@.
@.@@.@.@@...@.@.@.@.
@@@@@....@@.@.......
@@@@.@.@@...@.@@.@.@
@@@.......@@.@....@.
@@@@@.@.@.@...@.@...
@@@@..@@@@@.@@@@..@@
@@@@@.......@@@.@...
@@@@@.@.@@.@@@....@@
13
16 7 0
7 2 0
4 4 0
2 7 0
11 10 0
4 8 1
17 2 1
9 1 1
6 18 1
6 14 2
15 19 2
19 9 2
0 7 2

18 4 0
12 16 0
17 17 0
5 11 0
8 8 0
9 16 1
16 19 1
1 11 1
19 8 1
13 10 2
5 16 2
2 8 2
17 10 2
