width 20
height 20
@@@@@@.@@@@@....@.@@
.@@@.@..@@@.@.@....@
..@....@@@....@.@@@.
.@.@.@@.@.@@.@....@.
..........@...@.@...
.@@.@@@.@.@@.@.@..@.
..@@.@...@...@.@@..@
.@.....@@@.@....@.@.
.@@@.@@@@...@.@@....
.@....@@@@@.@...@.@@
..@@.@.@@...@.@@.@@@
@.@..@....@.@....@@@
@@.@.@.@@..@@@.@@.@@
@.......@.@@@......@
@@.@.@.@@@.@.@@@.@..
@...@@@.......@.@.@.
@@.@@@..@.@.@.......
@@@@@@@..@@@..@.@.@.
@@@@@@..@.@.@..@.@@@
@@@@@@@.....@@......
13
4 12 0
7 1 0
2 12 0
14 5 0
15 1 0
1 13 1
6 1 1
19 7 1
6 7 1
2 15 2
19 4 2
9 11 2
10 10 2

10 19 0
14 13 0
19 2 0
14 7 0
13 11 0
11 18 1
9 18 1
18 6 1
11 9 1
2 16 2
13 8 2
8 19 2
14 5 2
