width 20
height 20
@.@@.@...@..@@@@@@.@
.......@@@@.@@.@@...
.@.@.@...@...@..@@.@
..@@@.@@.@@.@@.@@@..
.@.@@...........@.@.
@@..@.@@@.@.@.@@@...
@@@......@@@...@..@.
@@..@.@@@@@@@.@@@..@
.@.@.@.@.@.@.@....@@
...............@.@@@
@.@.@@.@.@@.@@.@..@@
@@..@.@.@@.@.@@.@.@@
@@@......@......@..@
.@..@.@.@.@.@.@.@.@@
.@@..@@......@..@.@@
....@...@@.@.@.@.@@@
@.@@.@.@..@...@..@.@
...@....@..@.@@@....
@.@..@.@@@.......@@.
@.@@..@@@@@.@.@@@...
13
12 14 0
0 4 0
8 16 0
3 12 0
8 3 0
19 19 1
11 0 1
11 3 1
2 11 1
10 18 2
3 10 2
1 9 2
13 5 2

4 9 0
19 18 0
5 12 0
7 15 0
2 13 0
14 1 1
3 14 1
4 19 1
0 3 1
12 12 2
3 11 2
0 4 2
19 5 2
