width 20
height 20
.@@@@.....@..@@.@.@.
.@@@@@.@@...@.......
.@@@@@@@..@...@@.@.@
..@@@....@@@@..@.@@@
.@.@.@@@..@@..@..@.@
........@.@@@..@@...
.@.@.@.@.@.@.@.@.@.@
.@.@@...............
.@..@.@.@.@.@@.@.@.@
@..@.@.@.@.@@.@.@...
@@..............@@@.
@@@@.@@.@.@@@.@...@.
@@@@@@..@....@.@.@@@
.@@@@@@.@.@@....@@@@
.@@@@@@.@..@.@.@@@..
..@@@@@..@@@@...@@.@
.@.@@@@.@@@...@@@..@
.....@...@..@...@@.@
@@.@@.@.@@@.@.@.....
..........@@...@.@.@
13
16 7 0
14 8 0
13 5 0
2 10 0
15 18 0
17 0 1
14 17 1
8 2 1
0 2 1
12 16 2
2 8 2
8 9 2
15 17 2

16 18 0
7 11 0
12 16 0
7 15 0
2 17 0
4 5 1
13 13 1
15 15 1
0 1 1
11 12 2
8 10 2
7 16 2
5 7 2
