width 20
height 20
..@.@.@...@...@.@@..
.@......@@..@.....@.
...@.@@.@@@.@.@.@...
@.@.@@.@.@@.@@@.@.@.
............@..@..@@
@.@.@.@.@.@...@.@.@@
.@@.@@@@.@.@.@@.....
......@.....@.@.@.@.
.@.@@..@.@@......@..
@@.@@@@...@.@.@.@.@.
@.@.@.@@.@...@@@@...
..........@.@.@..@@.
@.@@.@.@.@@@...@..@.
..@@@...@@@.@.@.@.@.
@.@@@.@..@..........
...@@@..@@@.@.@.@.@.
@.@.@.@@.@...@...@..
..........@.@.@.@.@.
@.@.@.@.@@.....@....
...@..@@...@@.@..@@.
13
16 4 0
15 14 0
3 11 0
15 11 0
12 6 0
19 16 1
18 8 1
0 15 1
15 8 1
15 3 2
11 15 2
0 11 2
13 2 2

18 14 0
9 0 0
0 8 0
9 17 0
17 18 0
1 13 1
19 16 1
19 2 1
17 6 1
5 17 2
16 8 2
3 10 2
8 0 2
