width 20
height 20
.......@....@...@.@@
.@.@.@.@@@@..@@....@
..@@@@@@@@@@....@.@@
.@@@@@@@@@@..@.@..@@
..@@@@@@.@.@.@..@...
.@@@@@@@.....@@.@.@.
..@@@@...@@@.@...@..
.@.@.@.@.@....@.@@@.
......@...@.@.@@@@..
.@.@.@.@.@.@.@.@@.@.
..@..........@......
.@..@.@@.@.@..@.@.@.
.@@..@...@@..@@..@@@
..@@@@@@.@.@.@@@..@@
.@.@.@@.@.....@..@.@
@@.......@.@.@.@...@
...@.@.@....@@.@.@..
@.@@@@@..@.@.....@.@
@@.@.@.@..@@.@.@..@.
@........@@@@...@...
13
7 14 0
16 10 0
4 0 0
0 14 0
6 10 0
4 14 1
14 18 1
6 12 1
19 6 1
15 17 2
16 14 2
0 12 2
12 9 2

19 8 0
15 14 0
8 8 0
3 10 0
19 11 0
15 1 1
15 5 1
14 3 1
8 9 1
17 4 2
2 8 2
5 11 2
12 14 2
