width 20
height 20
@...@...@.....@.@.@@
@@.@.@.@.@@.@.....@@
@.........@@@@.@.@.@
@@.@.@@.@.@.@.@.....
@@@..@.@@.......@.@.
@@.@....@.@.@@.@.@..
@....@.@@.@.@@....@@
..@.@@@@@@.@.@.@@...
@..@@@@@@.....@..@.@
..@@@.@@.@.@@...@@..
@.........@...@@.@@.
..@.@.@@.@.@@.@.....
@.@@@@.....@@...@@.@
@@...@.@.@@@..@.@.@.
@@.@@.@@.@..@.@...@.
@........@.@@@@.@...
@@.@.@.@.@..@@.@@.@.
@@@@..@.@@.@.@.@.@..
@@@..@.............@
@@@@.@@.@.@.@@@.@@..
13
17 14 0
13 11 0
6 18 0
3 0 0
14 18 0
8 18 1
15 13 1
13 0 1
3 2 1
17 4 2
1 10 2
1 7 2
15 11 2

1 11 0
8 18 0
13 14 0
15 9 0
12 18 0
11 10 1
6 15 1
12 8 1
5 14 1
17 3 2
11 14 2
2 8 2
3 11 2
