width 20
height 20
@@@@@@@@@@@@@......@
@@@@@@@@@@@@@@.@.@..
@@@@@@@@@@@@@..@@.@@
@@@@@@@@@@@@@@....@.
@@@@@@@@@@@@@@@@@...
.@@@@@@@@@@@@@@@@@@.
..@@@@@@@@@@@@@@@@..
@..@@@@@@@@@@.@@@.@.
..@@@@@@@@@@@..@....
@.@@@@@@@@@@..@@@.@@
..@@@@@@@@@@@..@....
@.@.@@@@@@@@..@.@.@@
.....@@@@@..@.......
@.@.@.@@@@.@.@.@.@.@
@@.....@@.......@@@@
@@@.@@@..@.@@.@.@.@@
@@...@.@.....@.....@
@.@.@....@.@@@@.@.@@
@.....@.@..@.@.@....
@@.@.@@@@@@@.....@.@
13
16 8 0
3 16 0
14 10 0
18 4 0
12 16 0
3 18 1
17 18 1
2 12 1
1 8 1
14 8 2
10 15 2
16 19 2
3 17 2

3 18 0
12 18 0
0 8 0
16 0 0
15 0 0
18 4 1
13 2 1
0 6 1
9 16 1
2 18 2
14 18 2
17 0 2
18 8 2
