width 20
height 20
@@@.@@@@@..........@
@@@.@@@..@@.@@@.@@.@
@@@..@@@.@....@.@...
@@..@.@...@.@..@@@.@
@.@.....@.@@@@..@...
...@.@.@...@...@.@.@
.@.@@.@.@.@.@@.@...@
@...@.@........@.@..
.@.@....@.@.@.@@@@@.
.....@@@.@@..@...@..
.@@@.@....@.@@@.@.@.
@@@....@.@.@.@......
@@..@.@......@.@@.@.
@.@..@@@@@.@..@..@@.
..@.@@@@.@.@.@@@.@.@
@....@@...@...@.....
..@.@@@@.@.@@.@@.@.@
@..@@@@.....@.@@@..@
..@@@@@@.@@@......@@
@@@@@@@......@@.@..@
13
4 15 0
8 1 0
6 11 0
4 5 0
11 10 0
0 10 1
16 0 1
3 7 1
13 15 1
7 7 2
18 0 2
16 6 2
8 11 2

14 9 0
17 19 0
11 2 0
10 2 0
19 12 0
2 12 1
2 9 1
10 19 1
16 9 1
11 9 2
10 16 2
14 6 2
0 6 2
