width 20
height 20
@.........@@@@@@@@@@
.@.@.@@@.@.@@@@@@@@@
....@.......@@@@@@@@
@@.@@@.@.@.@@@@@@@@@
...@@@..@@@@@@@@@@@@
@@@.@@.@.@.@.@@@@@@@
.@@...........@@@@@@
....@.@.@@.@.@@@@@.@
.@.@.@@@@..@...@.@..
.@...@@@.@@..@.....@
..@.@@.@..@.@..@@.@@
.@.@@....@.@.@...@.@
...@@@@@.......@@...
@@.@@.@.@@@.@@@@..@.
.........@@@.@.@.@.@
@.@.@.@.@.@@........
...@@@.......@@.@.@.
@.@.@.@.@.@.@.@@.@@.
.......@@.@.@.......
.@@.@.@...@.@.@.@.@@
13
18 8 0
3 19 0
12 15 0
5 15 0
0 8 0
13 6 1
14 12 1
8 9 1
18 18 1
5 13 2
8 3 2
14 9 2
17 18 2

13 18 0
7 15 0
8 16 0
0 2 0
9 8 0
9 19 1
16 15 1
2 1 1
17 9 1
15 16 2
11 18 2
0 7 2
14 14 2
