width 20
height 20
..@@@..@.....@@@@@@@
.@.@@.@@@@.@..@@@@@@
.......@@@@.@.@@@.@@
@.@.@@.@@@....@@...@
@.@.@.@.@.@.@@.@@.@.
.@..........@.......
...@@.@.@.@...@.@.@.
@@...@...@@@.@@.@@@@
@@@.@@@.@@@@@@@@@@@@
@@@@@@@@@@@@@@@@@@@@
@@@@@@@@@@@@@@@@@@@@
@@@@@@@@@@@@@@@@@@@@
@@@@@@@@@@@@@@@@@@@@
@@@@@@@@@@@@@@@@@@@@
@@@@@@@@@@@@@@@@@@@@
@@@@@@@@@@@@@@@@@@@@
@@@@@@@@@@@@@@@@@@@@
@@@@@@@@@@@@@@@@@@@@
@@@@@@@@@@@@@@@@@@@@
@@@@@@@@@@@@@@@@@@@@
13
6 0 0
3 8 0
17 6 0
18 5 0
5 2 0
12 6 1
2 2 1
16 5 1
4 5 1
5 1 2
11 5 2
11 4 2
0 1 2

13 2 0
5 5 0
15 6 0
18 5 0
12 1 0
9 6 1
17 3 1
3 8 1
2 1 1
0 0 2
7 4 2
0 1 2
3 3 2
