width 20
height 20
@.@.@.@.@@@@..@.@.@.
.........@..@.@.....
@.@.@.@.@@@.....@.@.
.@.@@@...@@@.@@.@@.@
....@.@.@@@@@.......
.@@.....@@@@@@.@.@.@
.@.@.@.@@@@@@...@@..
...@@....@@@.@.@.@.@
@@.@.@.@@@@..@@.....
@..@.@...@.@...@.@@@
@@.@...@...@.@@.....
@...@@@..@....@@.@.@
.@@..@@@@..@.@@.@...
.@..@@@...@...@..@.@
...@.@.@.@.@.@..@@..
@@.....@@......@.@.@
@@@@.@.@.@@@.@@.....
@@@@@....@@@@..@.@.@
@@@@@@.@.@.@.@.@..@@
@@@@@@@..........@@@
13
19 16 0
1 11 0
15 4 0
16 19 0
16 11 0
19 2 1
8 17 1
0 1 1
18 7 1
19 14 2
4 15 2
13 9 2
13 19 2

7 11 0
12 16 0
19 16 0
14 5 0
13 11 0
13 6 1
8 13 1
0 7 1
14 18 1
3 12 2
5 15 2
16 4 2
8 11 2
