width 20
height 20
@@@...@.@..@@@..@...
@@.@@...@@..@@@...@@
......@....@.@..@.@.
.@.@.@.@.@....@.@.@.
.@@....@@@.@.@@.@@..
@@@@.@.@.@@...@...@.
@@@@@......@.@.@.@..
@@@@.@.@@.@.......@.
@@@@...@...@.@@@.@..
@@@..@.@@.@..@....@.
@@@.@@.@...@@@.@.@@.
@@....@.@.@@@@@.....
@.@.@@@.@..@@@@@.@.@
.....@....@.@@@@@.@@
.@@@..@.@@..@.@...@.
...@@@@@..@....@@...
.@@.@.@.@...@@.@.@.@
..........@.@.@.....
.@.@.@.@.@......@@@@
.@.@..@@..@.@.@.....
13
17 15 0
15 1 0
13 3 0
18 11 0
9 0 0
2 3 1
6 6 1
12 9 1
6 1 1
13 15 2
9 19 2
11 14 2
17 1 2

19 3 0
7 1 0
11 3 0
18 8 0
0 16 0
17 19 1
15 19 1
4 19 1
16 7 1
10 1 2
12 9 2
6 6 2
2 2 2
