width 20
height 20
@@.@@...@..@@@@@@@@@
@..@..@..@..@@@@@@@@
@.@.@@.@...@.@@@@@@@
.........@....@@@@..
@.@.@.@.@@.@.@@@..@.
...@..@@@@..@@@.@.@.
@.@..@.@.@@.........
..@@@@.....@@.@.@.@.
@.@.@..@@.@@@@...@..
.....@..@@@@@@.@@.@.
@@.@..@..@.@@@@@@.@.
.@..@.@@....@@@.....
..@@..@..@.@@@@@.@.@
.@@.@.@@.@@@@@@@@@..
..........@@@@@@@@@@
@.@.@@.@.@@@@@@@@@@@
...@...@@@@@@@@@@@@@
@.@.@@...@@@@@@@@@@@
.@.....@.@.@@@@@@@@@
...@.@.@....@@@@@@@@
13
15 5 0
15 8 0
11 3 0
9 19 0
6 15 0
19 9 1
11 6 1
3 6 1
0 18 1
8 14 2
4 1 2
10 7 2
19 13 2

5 0 0
3 11 0
0 18 0
14 6 0
6 15 0
8 7 1
16 4 1
7 12 1
1 3 1
7 1 2
8 1 2
14 9 2
4 18 2
