width 20
height 20
@@@@@@@@@.........@.
@@@@@@@@.@.@@.@@@...
@@@@@@@.....@@.@..@@
@@@@@@@@.@.@@@...@..
@@@@.@.@@@..@..@@..@
@@@@....@..@.@....@.
@@@@@.@@@@.@.@@.@...
@@@@@.@.@@.@..@@@@@.
@@@..........@@.@@@@
.@..@.@.@.@.@....@@.
.@@..@.@.@.@..@.@.@.
...@........@@......
.@.@.@.@.@.@..@.@@.@
..@.@.@@@....@.@....
.@@....@@@.@.....@@@
....@.@.@.@..@.@....
@@@.@@......@.@..@.@
@@.....@.@.@...@.@..
@@@@.@..@@@@@.@.@.@.
@@....@@............
13
15 3 0
17 2 0
6 10 0
13 19 0
1 11 0
12 7 1
10 8 1
11 2 1
0 10 1
10 17 2
16 13 2
5 19 2
3 8 2

19 3 0
11 13 0
11 16 0
10 7 0
6 17 0
17 2 1
0 12 1
14 14 1
13 16 1
19 13 2
14 5 2
17 1 2
4 11 2
