width 20
height 20
@@@..@@@...@@@@@@@@@
@@..@.@..@.@@@@@@@@@
@.@....@.@@.@.@@.@@@
....@.@..........@.@
@.@.@..@.@@.@.@@....
...@..@....@@.@@.@@.
@.@@@..@.@.@..@.@.@.
.@@@..@@.@.@@.@....@
..@.@..@@..@....@.@.
@.....@@@@.@@@@.@...
..@.@.@@@@.....@@.@.
@.@@...@@@.@.@...@@@
..@@@.@@@.@@..@@@@@@
.@.@@..@.....@@.@@@@
....@.@@@.@.@....@@@
.@@.@..@@@....@@.@@@
.@.@.@@.@.@@.@....@@
.............@.@.@@@
.@.@.@.@.@.@..@@..@@
..@@..@..@.@.@...@@@
13
19 9 0
0 8 0
16 5 0
16 11 0
10 7 0
10 13 1
1 11 1
5 13 1
1 4 1
1 8 2
1 10 2
8 0 2
10 10 2

3 2 0
11 14 0
13 14 0
2 1 0
15 7 0
16 11 1
5 9 1
15 19 1
4 9 1
12 18 2
10 10 2
14 3 2
6 13 2
