width 20
height 20
.@.....@@@@@@@@@@@@@
...@.@.@@@@@@@@@@.@@
@@..@@..@@@@@@@@@...
...@@@.@..@@@@@.@.@.
@@..@....@.@@@.....@
@@.@@@.@......@.@@@.
@.@@.@@.@@.@.@......
@.@........@..@@.@@.
...@.@.@@.@@@...@...
.@.@..@..@.@.@.@.@.@
.@@..@.@.....@@@....
.@.@.@...@.@.@...@.@
.......@..@@..@@..@@
@.@@.@@..@@..@...@@@
...@@.@.@@@@...@..@@
@.@....@@@@@.@@..@.@
@...@.@@@@@@@@@@....
..@..@@@@@@@@@@.@.@@
.@..@@@@@@@@@@.....@
..@.@@@@@@@@@@@.@.@@
13
1 8 0
16 11 0
18 4 0
16 9 0
4 7 0
10 4 1
15 8 1
3 12 1
19 16 1
6 15 2
4 9 2
2 8 2
15 4 2

15 3 0
9 8 0
7 4 0
17 12 0
1 7 0
17 3 1
14 14 1
18 8 1
17 19 1
15 4 2
1 19 2
0 12 2
7 9 2
