width 20
height 20
.@.@@....@...@@@...@
.@...@.@@.@.@.@..@@.
...@@...........@...
@.@..@@.@.@.@.@...@@
....@.@..@@@@@@@@...
@.@...@@..@.@.@.@.@.
...@@...@@@.......@.
@.@@@.@@....@@@@@@..
...@....@@@.@@.@@@.@
@.@.@.@.@.@..@...@.@
@.@....@@...@.@.@.@.
..@.@.@@@.@@........
@..@@@.@..@..@@@.@.@
..@@@@..@..@.@...@.@
.@@@@..@.@....@@..@@
.....@.....@.@...@.@
.@.@...@@.@...@@....
@...@.@....@.@...@.@
@@.@@@..@.@@@..@@...
@@.@@@@.@..@@@..@@@.
13
13 2 0
7 8 0
14 19 0
13 14 0
3 11 0
16 14 1
19 16 1
9 10 1
4 8 1
1 12 2
5 4 2
3 1 2
16 3 2

9 15 0
6 0 0
6 2 0
17 16 0
4 1 0
5 17 1
1 12 1
18 4 1
3 10 1
0 15 2
17 0 2
5 0 2
2 1 2
