width 20
height 20
@@@@@@..@...@...@@@@
@@@@@@.@.@@...@.@@@@
@@@@@.......@@@@@@@@
@@@@..@.@@@.@.@.@...
@@@..@...@.......@@.
.@.@.@@.@@@@.@.@....
......@@.@@@@@@..@.@
.@.@.@....@@..@.@.@@
@...@@@.@.@.@......@
.@.@.@@@..@...@.@.@.
......@..@.@.@.@@...
.@.@.@@@...@@@.@@.@@
.@@...@..@..@...@.@.
...@.@.@.@.@..@.....
.@.@@...@...@@.@.@.@
@.....@..@.@.@....@@
@@.@@@..@......@.@.@
@@@@@@@..@.@@.@@....
@@@@@@..@.@.@@...@@.
@@@@@@@.......@.@@..
13
4 10 0
18 3 0
7 10 0
7 8 0
12 19 0
2 16 1
14 14 1
7 4 1
17 3 1
19 12 2
14 4 2
13 1 2
3 15 2

10 14 0
9 7 0
0 13 0
5 15 0
16 6 0
6 1 1
15 8 1
7 17 1
7 16 1
4 13 2
11 2 2
2 13 2
18 17 2
