width 20
height 20
@...@@@@@@@..@@@....
@@.@.@@.@@..@.@@@.@.
...........@@.@@@@@.
.@.@.@@@.@....@@@...
..@...@.@.@.@..@.@@.
@@@@.@@...@..@....@.
@..@.@..@@.@.@.@.@@.
@.@@@@@.......@@....
..@@@@..@@.@@.@@@.@.
.@..@.@@@...@..@..@.
...@......@.@.@.@@.@
@@.@@.@.@.@.@@......
@@..@@.@..@.@@@.@@@@
@..@.@.@@@...@@.....
@@........@.@@..@@.@
@..@.@.@.@.....@@@..
@@..@...@@@@.@@....@
@@@@.@.@.@.@@...@@..
@@@...........@...@@
@@@@@.@@.@@.@..@.@@@
13
1 0 0
5 9 0
2 6 0
6 17 0
7 6 0
2 15 1
8 10 1
2 13 1
16 6 1
2 12 2
18 10 2
17 18 2
18 15 2

0 4 0
9 10 0
5 18 0
10 18 0
9 14 0
9 9 1
6 12 1
11 10 1
15 14 1
18 0 2
18 3 2
16 0 2
3 0 2
