width 20
height 20
..@.@@@...@@@..@.@@@
@.......@@@@@.@..@@@
..@@.@.@@@@@@..@.@@@
@..@.@@@@@.@.@.@.@@.
..@@@.@@@...........
@......@@.@.@.@@@.@@
..@.@.@.@.@..@@....@
@@.@@.@.@@.@.@..@.@.
.@......@.....@..@..
...@.@.@@@.@.@@@..@.
.@.@@@@@@@@...@@@@..
..@@.@.@.@.@.@.@.@@.
.@@.................
....@.@@.@.@.@@@@@@.
@.@..@@@.@..@@@@@@@.
@.@.@...@..@.@..@@..
..@.@.@..@@....@..@.
.@.@.@.@.@.@.@@.@...
@@..............@.@.
@@.@@.@.@.@.@.@....@
13
4 2 0
5 4 0
4 9 0
12 3 0
0 11 0
8 18 1
11 5 1
9 6 1
14 0 1
18 19 2
1 4 2
13 2 2
14 11 2

4 1 0
15 4 0
16 1 0
0 11 0
5 18 0
14 15 1
10 18 1
2 19 1
14 16 1
7 12 2
1 3 2
18 19 2
14 11 2
