width 20
height 20
.....@@@@@@@@...@.@.
@.@.@.@@@@@@..@.....
@@......@.@.@..@@.@.
@@@.@.@@@.@...@@.@..
@@@@...@..@.@.@..@.@
@@@.@.@.@.@@...@...@
@@.........@@.@@@.@@
.@@.@@@@@.@.....@.@@
..@..@.@.@.@@.@@.@.@
@.@.@......@........
....@@.@.@.@@.@.@@.@
@.@@.@..@@@...@@....
.....@.@@@@@.@..@.@@
.@.@.@..@@@@.@.@@.@.
..@....@@@@.@@......
.@..@.@.@@@....@.@.@
@@@..@@..@@.@.@@@...
.@@.@@.@.@..@@@@@@.@
.........@.@@@@@@...
.@@.@@.@....@@@@@@.@
13
7 18 0
3 9 0
11 16 0
14 13 0
19 1 0
10 18 1
8 10 1
4 11 1
6 8 1
5 2 2
19 9 2
16 5 2
0 17 2

4 0 0
3 0 0
17 14 0
3 8 0
14 2 0
12 3 1
8 18 1
17 11 1
5 14 1
3 14 2
6 19 2
11 14 2
14 13 2
