width 20
height 20
@@@@@@@...@...@.@.@@
@@@@@@.@.@@.@@.....@
..@@@.........@@.@..
@..@@.@.@@@.@..@@@.@
..@...@@.@@@..@@@@..
@...@.@..@@@.@@@@@.@
@@.@....@.@.@.@@@...
@@@.@.@.@......@.@.@
@....@....@@@.@.....
@@.@..@.@@....@.@@.@
@.@..@@@.@@@@....@..
...@..@...@...@.@..@
.@..@..@.@@@.@.@@@..
..@@.@....@....@@@@.
@......@.@.@.@.@@@@.
@@@.@.@.@...@..@....
@@@@.....@@..@.@@.@.
@@@@@.@.@@@@...@...@
@@@@..@..@@@.@@@@@..
@@@@@..@.......@@@@.
13
7 13 0
11 15 0
2 3 0
16 1 0
4 18 0
12 0 1
0 2 1
15 0 1
13 9 1
9 2 2
13 2 2
1 3 2
13 6 2

13 13 0
7 0 0
13 6 0
14 16 0
8 18 0
8 1 1
19 19 1
6 6 1
13 0 1
1 13 2
14 7 2
14 15 2
3 10 2
