width 20
height 20
@.@@@@@@@@.@.@.@.@.@
.....@@@@@.@...@....
@.@.@@@@....@@...@.@
..@@@@@.@.@@@@.@..@@
@.@@@@......@...@@@@
...@@@.@@@@@.@.@.@@@
@.@.@...@@.@.....@@@
.....@.@.....@.@..@@
@.@@.@...@.@..@@@...
...@@@.@.@@.@@@@..@@
@.@..@..@@@.@..@@.@@
...@..@...@...@.@@.@
@.@.@.@.@@..@.......
........@.@.@.@.@.@.
@.@@@.@.@.@@.@..@@@@
.....@.@.....@@..@@@
@.@@.....@.@....@@@@
@@...@.@@...@@.@@@@@
@..@.@...@.@@@.@@@@@
@@@...@.@@..@@@@@@@@
13
13 16 0
11 11 0
7 19 0
16 2 0
12 8 0
1 3 1
6 5 1
14 2 1
6 9 1
4 17 2
1 9 2
9 7 2
7 16 2

6 6 0
14 4 0
11 10 0
16 9 0
9 3 0
10 6 1
11 19 1
0 3 1
15 12 1
17 7 2
1 6 2
6 4 2
1 8 2
