width 20
height 20
@@@@@@@@@@@@@.@.@...
@@@@@@@.@@@@......@.
.@@@@@@.@@.@@@.@@..@
..@@@@......@.@.@.@.
.@.@@.@.@.@@........
.........@@@@@.@@@@.
@.@.@.@@@.@@....@@@@
...@@........@.@.@..
@.@@@.@.@.@.@......@
...@...@@@@@@@.@@@..
@.@@@.@@@.@.@.@.@.@.
..@@@@@@............
@..@.@@.@.@.@.@.@.@.
..@@.@.....@@@@@...@
@@....@.@.@@@@@@@@.@
@@@.@@...@@@@@@@@@@@
@.....@@.@@@@@@@@@@@
@@@.@.....@@@@@@@@@@
@@@@@@.@.@@@@@@@@@@@
@@@@@@@@@@@@@@@@@@@@
13
15 1 0
14 6 0
2 7 0
7 5 0
13 3 0
14 7 1
6 5 1
9 3 1
11 12 1
18 7 2
15 10 2
18 2 2
2 4 2

14 2 0
13 11 0
16 13 0
6 5 0
15 4 0
1 11 1
7 15 1
10 3 1
17 13 1
5 14 2
7 17 2
10 2 2
9 11 2
