width 20
height 20
..@@@.@.@.........@@
@..@......@.@.@.@..@
@@..@.@.@@.@@.@@..@@
@..@@@.....@.@@@@.@@
..@@@.@@@@....@@....
@..@...@...@.@@@.@.@
..@.@.@.@.@.@.@.@.@@
@.@...............@@
....@.@.@@.@@@@.@..@
@.@.@@.@@..@.@..@.@@
@@......@.@@..@@...@
..@.@.@.@@@@.@..@.@.
@....@@@.@.@..@.@...
@.@.@.@......@..@.@.
..@....@.@.@.@@..@@.
.@..@.@..@.@@.@.@.@.
..@@...@..@.........
@.@.@.@..@.@.@@@.@.@
..@....@......@@@...
@.@@.@.@.@@@.@@@@@.@
13
10 12 0
13 2 0
18 19 0
8 17 0
9 13 0
17 10 1
17 1 1
16 5 1
10 3 1
1 7 2
11 6 2
2 10 2
5 8 2

12 19 0
12 10 0
16 17 0
5 13 0
3 9 0
17 12 1
0 8 1
1 16 1
7 11 1
16 16 2
17 1 2
7 15 2
7 13 2
