width 20
height 20
@@@..@@@@@..@..@@@@@
.@@@..@.@.@...@@.@@@
..@..@....@.@@.@.@@@
.@.@.@@.@......@.@.@
......@@.@.@.@......
@.@.@.....@.@@@@.@.@
@..@@@.@@.@.@@@...@.
..@.@.@@.@...@.@.@..
@..........@.....@@.
@@.@.@.@.@..@.@@.@..
@@@.@...@..@..@....@
....@@.@@@@.@@@@.@@@
@@.@.@..@@@..@@@...@
.......@@@..@..@@.@@
@.@.@@.@@@@...@.@@@@
...@..@@@@@.@.....@@
@.@@@..@@@.@.@@.@..@
...@.@...........@@@
.@.....@@.@@.@.@.@..
.@.@.@...@....@....@
13
13 14 0
12 16 0
13 10 0
16 19 0
11 11 0
4 15 1
4 18 1
12 3 1
5 10 1
0 7 2
14 15 2
16 4 2
18 9 2

14 7 0
2 12 0
14 8 0
12 3 0
5 10 0
14 15 1
16 6 1
6 8 1
11 2 1
13 8 2
4 3 2
13 14 2
9 3 2
