width 20
height 20
@@@@@..........@@@@@
@@@@.@@.@@.@.@.@@@@@
@@@..@.@...@@..@.@@@
@@@@.....@..@@.@..@@
@@@@@@.@.@.@.@.@.@.@
@@@@..@.@.@.........
@@@.@.......@.@@.@@.
@.....@@@.@..@@@...@
@.@.@..@@@@@@.@.@.@@
...@..@.@.@.@....@..
@.@.@@........@.@.@.
.....@.@@@.@@.@.....
@@.@.@..@@..@@@@.@@@
@@@...@...@@.@@....@
.@.@.@..@@.@.@.@.@..
.......@.@........@@
@.@.@@@....@@@.@.@@.
..@..@.@.@.@.@@...@.
.@.@@.....@@.@.@@...
.....@.@.@........@.
13
10 10 0
16 7 0
14 9 0
13 5 0
4 5 0
3 11 1
4 12 1
9 0 1
9 7 1
11 6 2
12 18 2
8 10 2
9 10 2

7 13 0
18 7 0
6 17 0
5 5 0
13 8 0
6 2 1
15 9 1
4 13 1
6 15 1
1 19 2
4 1 2
4 2 2
2 9 2
