width 20
height 20
@@.@.@.....@..@..@@@
.......@.@.@@..@.@.@
.@.@.@..@..@@@......
..@@.@@@..@.@@.@.@.@
@.@.@.@.@@...@..@...
@.......@@.@...@@@@.
@@.@.@@....@.@.@....
@@..@..@.@.@@@..@.@.
@.@..@.@.@@@@.@.@@@@
....@..@@@.@.....@@@
.@.@@.@@.@.@@.@.@@.@
@@.........@...@@...
@@.@.@.@@.@@@.@.@.@.
@.@@@....@.@......@@
@.@@@@.@...@.@@.@...
@...@.@..@.@..@.@.@.
..@...@@..@.@@@@...@
.@.@.@.@.@@...@.@.@@
...@@@....@.@......@
.@.....@.@@@..@.@.@@
13
14 11 0
0 10 0
5 16 0
9 11 0
7 5 0
2 15 1
5 13 1
6 1 1
14 13 1
15 18 2
14 1 2
14 2 2
7 15 2

1 3 0
1 5 0
10 5 0
17 17 0
6 8 0
2 1 1
15 0 1
12 19 1
15 2 1
4 8 2
0 19 2
1 18 2
2 6 2
