width 20
height 20
@.@....@..@@.@@@.@@@
...@.@..@.....@..@@.
@.@.@@@...@.@@@.@.@.
.....@.@.@@@.@......
.@.@...........@@@@.
..@@@.@.@@.@.@.@@.@.
@....@@@@.@.@.@.@...
@.@.@.@...@.......@.
.@.....@.@@@.@@.@@.@
..@@@.@...@.@.@....@
@.@...@.@@......@.@@
....@@..@@@.@@.@@@@@
@@.@.@.@@@@@.@@@@.@.
@..@.@....@....@....
@@.....@@.@.@.@@@.@.
@@.@@.@......@@@@@..
@@@..@@.@.@.@@@.@.@.
@@@.@@.@.@@.@.......
.@............@@.@@.
...@.@.@@.@.@@@@@...
13
7 18 0
3 3 0
15 10 0
1 6 0
5 9 0
13 17 1
15 16 1
0 18 1
6 14 1
17 13 2
4 6 2
5 5 2
9 16 2

6 8 0
12 1 0
3 14 0
1 6 0
8 8 0
3 8 1
11 13 1
3 3 1
12 0 1
1 2 2
2 11 2
11 16 2
4 0 2
