width 20
height 20
..@@@@........@@@@.@
.@.@.@@.@@.@.@.@....
.....@....@@.....@.@
@.@@...@.@@@@@.@@.@.
@@.@@@.@@.@.@.@.....
@...............@.@.
..@@.@.@.@@@.@@@@.@.
@...@@@.....@.@.@.@.
.@.@.@@.@.@@@....@..
.....@.@@@@@@.@.@.@.
@.@@@..@@.@@...@....
.@.@.@.@@.@.@.@.@.@.
.@..............@..@
.@.@@.@.@.@.@@.@.@..
..@@@@...@.@.......@
.@@@@@@.@...@.@.@.@.
..@@@@....@@...@....
.@.@@.@@@.@.@.@.@.@.
..........@......@..
@.@.@@.@.@@@@.@@..@.
13
0 8 0
3 19 0
19 13 0
12 0 0
4 5 0
7 1 1
6 2 1
8 3 1
1 10 1
0 0 2
14 3 2
7 12 2
12 16 2

2 18 0
14 2 0
13 14 0
7 2 0
0 17 0
0 15 1
18 8 1
10 15 1
2 1 1
1 6 2
11 5 2
3 5 2
5 13 2
