width 20
height 20
@.@.@..@............
.....@.@@@.@.@.@.@.@
@@.@@@...@@..@.@..@@
@@.@@..@.@.@..@@@@.@
@....@..@....@@@.@.@
@@@.@..@..@.@.......
@.....@.@.@@.@.@@.@.
..@.@.........@...@@
.@.@@.@.@.@.@.@@@..@
@@...@.@@@@@..@.@@..
@..@.@..@.@.@......@
@.@.@.@...@...@@@@@.
........@...@.......
.@.@.@.@@@@@..@.@.@.
..@@@.@@.@@@@..@@@..
.@@@......@@@@@.@.@.
..@.@.@@.@.@.@..@...
.@..@.@......@@...@.
.@.@.@.@@@.@@@@@@..@
..............@...@@
13
18 18 0
9 7 0
5 5 0
4 13 0
19 14 0
12 9 1
7 17 1
3 11 1
19 17 1
16 19 2
19 12 2
11 8 2
4 12 2

5 14 0
8 19 0
10 17 0
1 11 0
5 15 0
3 7 1
13 11 1
6 10 1
5 16 1
3 6 2
5 17 2
5 6 2
2 18 2
