width 20
height 20
@@.@...@.@@@.......@
@...@@.@..@..@@.@.@.
.@.@.@.@.@..@@.@..@.
...........@@@..@...
@@@.@@.@@@.@..@.@.@.
.@....@@@.@@@.@..@..
..@.@@@@...@...@..@@
.@....@.@.@.@@...@.@
..@.@..........@@...
.@.@@.@.@@.@.@@@@@@.
.......@....@..@@.@.
@@.@@.@@@@.@.@......
@@...@@@@@...@.@@.@.
@..@@.@@@@.@....@@..
@@....@@@@@@@@@.@@@.
@@@@.@@@@@@@@@@@@@@.
@@@@@@@@@@@@@@@@@@@@
@@@@@@@@@@@@@@@@@@@@
@@@@@@@@@@@@@@@@@@@@
@@@@@@@@@@@@@@@@@@@@
13
16 5 0
12 4 0
8 6 0
6 0 0
10 8 0
19 1 1
16 0 1
17 11 1
3 7 1
13 5 2
0 9 2
4 0 2
5 7 2

17 4 0
17 6 0
10 10 0
14 10 0
4 12 0
13 4 1
8 1 1
14 8 1
8 6 1
5 0 2
19 4 2
11 10 2
4 5 2
