width 20
height 20
...@..@..@.@...@.@@@
@.@.@..@.....@...@@@
.....@.@@@@@.@.@..@.
@.@.@....@@@@...@...
@@....@@.@.@@@.@..@@
@@@.@...@......@@...
@@@.@@.@@.@@.@@@..@.
@@@..@.@.@@...@..@..
@@@@@@.....@.@.@@@@.
@@...@.@.@.....@.@..
@.@.@@@@@@.@.@@...@.
.....@....@....@.@@.
@.@.@.@.@@@@.@.....@
...@.......@@..@.@@.
.@@.@.@.@.@.@@.@....
.......@@@@..@..@.@.
@.@.@.@@.@..@.@@@@..
...@.@.@..@...@@@.@.
@.@......@.@@.@.....
....@.@@........@.@.
13
18 7 0
8 1 0
13 0 0
5 0 0
17 2 0
17 12 1
9 6 1
10 5 1
3 11 1
10 16 2
0 0 2
2 11 2
0 19 2

0 0 0
5 14 0
3 19 0
11 9 0
6 1 0
16 12 1
13 18 1
4 0 1
1 15 1
1 2 2
10 1 2
19 10 2
15 12 2
