width 20
height 20
..@..@..@.@@...@..@@
.@@.@.@.@.@.@.@.@.@@
...................@
@@@.@.@@.@@.@@.@@@.@
@@@@@.@.@...@.....@.
@@@..@...@.@.@.@.@..
@@@.@.@@.@....@@..@.
@@....@..@.@.@@@.@..
@.@.@...@@@..@.@@.@.
....@.@..@.@........
.@.@.@@.@..@@@.@@@.@
.@@......@.@@@@.....
@@@@.@.@....@@@@.@.@
@@....@@.@.@@@@...@.
@@@.@...@@.@.@.@@...
@@@@.@.@@@@.......@.
@@@@...@@..@@@.@.@@.
@@@@@@....@.....@@@@
@@@@@@@.@...@@.@.@@@
@@@@@@@@@@@@......@@
13
16 9 0
6 16 0
18 2 0
10 4 0
15 17 0
16 6 1
11 2 1
2 10 1
17 19 1
1 8 2
8 6 2
5 3 2
7 17 2

6 11 0
7 7 0
5 4 0
17 14 0
7 11 0
16 4 1
18 11 1
2 2 1
12 8 1
16 9 2
8 6 2
2 13 2
18 3 2
