width 20
height 20
...@@@...@..@.@..@.@
@.@.@..@...@....@..@
.....@.@@.@.@.@@.@..
.@.@.@.@..@........@
@@@....@@...@.@@.@@@
@@.@.@..@@.@@@@@.@.@
@.....@.@@@.@@@@....
@.@@.@.@@.@..@@.@@.@
@@......@.@.@.@.@@@@
@.@@@.@.....@.@.@@@@
.....@@.@@@.......@@
.@.@...@..@.@.@.@.@@
..@@@.@.@.@@.@.@..@@
.@@@.@...........@.@
.@.....@.@.@.@.@....
...@.@.@@.@.@@@..@.@
@@..@@@@@.@..@@@..@@
...@.@..@..@.@.@.@@@
.@...@.@.@......@@@@
..@@.......@.@@..@@@
13
16 19 0
3 14 0
15 10 0
2 11 0
2 16 0
16 0 1
4 6 1
5 14 1
0 15 1
12 16 2
10 13 2
12 17 2
17 12 2

12 18 0
13 10 0
7 17 0
16 3 0
6 8 0
13 1 1
6 11 1
1 6 1
14 10 1
10 4 2
8 0 2
18 0 2
10 18 2
