width 20
height 20
..@@@@.@@@@@@@@@@..@
.@.@@...@.@@@@@@@@.@
......@....@@@@@....
@.@@.@..@.@@@@@.@@.@
@@.@..@@.@.@@@......
@@...@@..@.@.@@@.@.@
@..@.@..@.......@...
..@.@.@.@@.@.@.@.@@.
@..........@@.......
.@.@.@@.@.@..@.@@.@@
....@@@@@@..@@..@@..
.@@.....@@@..@.@.@.@
@@@.@.@...@.@.......
@@@@@@..@....@@.@@.@
.@@.@.@@@.@.@@...@@@
..@........@..@.@...
.@..@.@.@.@@.@@@.@.@
..@..@.@.@@.........
@...@@.@.@.@.@.@.@@.
..@..........@@..@@.
13
9 1 0
12 15 0
17 4 0
8 8 0
9 15 0
0 16 1
4 6 1
2 6 1
5 1 1
19 2 2
7 8 2
16 18 2
11 6 2

2 8 0
11 11 0
7 15 0
17 6 0
1 6 0
9 1 1
11 19 1
12 19 1
12 15 1
1 19 2
0 15 2
16 2 2
7 13 2
