width 20
height 20
.@@@.@.@.@..@@@@@@@@
..@.......@.@@@@@@@@
.@.@@@.@@....@@@@@@@
.....@@...@.@@@@@@@@
@@.@@.@@.@.@..@@@@@@
.@...........@.@@@@@
...@.@.@.@.@....@..@
@@..@...@@@.@@.@.@..
.@.@.@@@@@.........@
..@...@.@.@.@@.@.@..
.@@@.@.......@.@@.@.
..@....@.@@.@@..@.@.
.@.@@@..@.....@@....
....@..@@.@.@..@@.@.
@.@..@..@.@.@.@@...@
@.@.@@.@.@.@.@@.@.@@
@@..............@@@@
@@@@.@.@.@.@.@.@@@@@
@@@@..@...@...@@@@@@
@@@@@.@.@@@@.@@@@@@@
13
11 10 0
3 1 0
6 0 0
6 6 0
0 11 0
6 16 1
5 7 1
11 8 1
1 11 1
14 5 2
13 4 2
6 1 2
12 12 2

12 18 0
10 2 0
18 8 0
7 16 0
19 12 0
5 16 1
11 12 1
5 11 1
4 0 1
0 10 2
10 4 2
10 8 2
17 15 2
