width 20
height 20
@..@@..........@.@@.
..@..@@.@.@.@@@..@..
@.@.@....@@@@@..@.@.
......@@..@@@.@.....
@.@@@.@..@.@....@.@.
.@.@..@@@..@@.@@.@..
...@@.@.@@.@.@.@.@.@
.@..................
.@.@.@.@@.@@.@@.@.@.
@..@@.@.@...@..@.@..
..@@@.....@@.@.@.@@.
.@@@@@.@@.@.........
@@@@@.@@.@.@.@@.@.@.
@@@@@.@.......@..@@@
@@@@....@@.@.@..@@@@
@@@@@.@...@@@@.@@@@@
@@@@...@.@.@..@@@@@@
@@@@@@@@.....@@@@@@@
@@@@@@@@.@.@@@@@@@@@
@@@@@@@@@...@@@@@@@@
13
19 11 0
5 13 0
8 4 0
6 10 0
19 0 0
7 1 1
9 13 1
2 7 1
17 3 1
15 3 2
15 1 2
12 14 2
17 11 2

18 6 0
9 8 0
6 11 0
7 2 0
19 8 0
5 6 1
10 14 1
2 7 1
16 10 1
14 9 2
10 6 2
14 6 2
7 13 2
