width 20
height 20
.@@...@@.@..........
..@.@.@...@@@.@.@@.@
.@.@...@.@.@...@@@.@
.@...@.....@.@@.@.@.
...@.@.@.@.@........
@.@.@..@.@@.@.@.@.@.
....@.@.@.@....@@@..
@.@@....@...@@.@@@@.
@@...@.@@.@.@.@.@@..
@.@.@.@@@.@@......@.
...........@@.@@@...
.@@.@@@.@.@@@@..@.@@
@..@.....@@@@.@.@...
@@..@.@.@@@@@.....@.
@@@.@..@@@@@@@.@@@..
@...@.@.@@@@@@@@@@@.
..@@.....@@@@@@@@@@@
@.@@.@.@@@@@@@@@@@@@
......@@@@@@@@@@@@@@
@@.@.@@@@@@@@@@@@@@@
13
4 7 0
15 11 0
19 12 0
5 9 0
7 15 0
8 4 1
3 14 1
5 7 1
1 10 1
0 3 2
16 4 2
12 4 2
4 4 2

14 13 0
2 18 0
9 10 0
17 10 0
3 18 0
5 18 1
5 12 1
13 12 1
4 7 1
4 3 2
2 6 2
1 5 2
19 6 2
