width 20
height 20
@......@@.......@@@.
@@.@@@.@.@.@@.@@.@@.
.@@........@..@.....
...@.@.@.@..@@@.@.@.
.@..@..@@@.@@..@@.@.
@.@.@@....@.@@.@.@..
.......@.@.........@
@.@.@.@..@@.@@.@.@..
...@@@@@.@@@...@@.@@
@.@.@@@.@.@.@@.....@
.............@.@.@..
@.@.@.@.@.@.@@@@@..@
..@@@..@.@@..@.@.@..
@....@....@@.......@
@.@.@@@.@..@@@@.@@.@
..@.@@.@..@@@@....@@
@@@@@....@@@@@@.@@@@
@@@@@@@.@@@@@@....@@
@@@@@@@.@@@@@@@.@..@
@@@@@@@@@@@@@@@.@.@@
13
2 3 0
8 8 0
16 5 0
8 15 0
9 5 0
0 10 1
7 5 1
1 15 1
14 8 1
14 9 2
10 1 2
6 10 2
3 2 2

3 13 0
16 12 0
16 5 0
15 3 0
6 12 0
7 9 1
18 12 1
19 4 1
15 15 1
3 2 2
14 13 2
9 14 2
5 2 2
