width 20
height 20
.@.@..........@.@..@
....@.@@.@.@@.@...@@
@@@.....@@@@@.@.@.@@
...@@.@@.@.@...@...@
@.@........@@@...@@@
....@.@.@@@.@..@...@
@.@..@@.@.....@..@.@
@@@@@..@@@@.@@.@@...
@@@.@.@@@@......@@.@
@@......@@@@.@.@@@@@
@.@@.@.@.@@@..@..@@@
@...@........@.@..@@
.@.@@@.@.@.@.....@@@
...@.@@@@.@@.@.@@@@.
.@.....@....@....@..
..@.@.@@@.@.@@@.@.@.
.@.@@..@@@..........
....@.@@@@@.@.@.@.@.
.@.@.@.@.@.@@..@@@..
@.............@@@@@.
13
2 19 0
8 14 0
17 3 0
0 5 0
14 8 0
4 10 1
19 14 1
10 16 1
8 0 1
11 15 2
6 4 2
5 9 2
5 11 2

4 19 0
14 11 0
10 16 0
6 14 0
10 8 0
5 11 1
12 16 1
8 1 1
0 15 1
7 5 2
13 14 2
11 8 2
12 8 2
