width 20
height 20
....@@..@........@@@
@.@@.@.@@@.@@.@.@.@.
.....@..@...@@......
.@.@.@.@.@.@...@.@@.
.@@@@.....@@.@..@@..
...@@.@.@@....@.@.@.
.@.....@...@@.@.@...
@@@@@.@.@.@....@..@@
........@@@@@.@@@...
@.@.@.@.@.@.@@.@.@.@
@@@.@@..............
@.@@@@@.@@.@.@.@@.@.
...@...@...@@....@..
@.@.@.@..@..@@.@@.@.
........@..@..@.@.@.
@.@.@.@.@@...@......
@..@.@@@@@@@..@.@.@.
..@@.@@@@@@@@@...@@.
@....@@@@@@@@@@.@...
@@.@@@@@@@@@@@@@@@@.
13
9 10 0
5 5 0
6 6 0
13 0 0
3 13 0
19 1 1
1 14 1
0 6 1
9 14 1
16 9 2
16 12 2
3 6 2
17 13 2

0 3 0
8 10 0
11 7 0
1 14 0
3 13 0
2 18 1
2 19 1
5 4 1
12 14 1
13 14 2
17 10 2
6 4 2
15 1 2
