width 20
height 20
....@@.@.@..@.......
@.@........@.@.@.@.@
@@..@.@.@@......@..@
@@@..@....@.@@.@.@.@
@@..@.@.@.@..@....@.
@@@@...@..@.@..@.@..
@@@@.@@.@..@.@..@.@.
.@@.....@.@....@....
..@.@@@.@@.@.@@.@.@@
@.@.@.@.............
...@@...@.@@.@@.@.@@
@.@.@.@@.@@.@..@...@
............@@..@@@@
.@.@.@@.@.@....@..@@
..@@@@.@..@@.@.@@..@
.@.@...@.@.@@.....@.
.....@@@....@.@@.@..
.@.@...@.@.@....@.@.
@@@@.@@.@..@@.@.....
@@@@.....@.@@@..@.@@
13
11 2 0
11 3 0
6 5 0
14 4 0
4 6 0
14 5 1
12 9 1
7 3 1
14 17 1
10 6 2
19 18 2
9 18 2
14 6 2

4 3 0
7 13 0
4 7 0
2 13 0
1 16 0
19 15 1
14 9 1
9 7 1
6 7 1
9 6 2
13 15 2
13 5 2
5 19 2
