width 20
height 20
@@@@@@@@..@@@@@@@.@.
@@@@@@...@@@@@@@....
@@@@@@@@.@@@@@@.@.@.
@@@@@@@..@@@@@.....@
@@@@@..@..@@@.@.@.@.
@@.@@@...@@.....@...
@..@@.@@..@.@@.@..@.
.@....@..@....@@@@..
...@.@@@.@@.@.@@@.@.
.@.@.......@..@@...@
.@@.@.@.@.@@@.@.@@.@
....@.@@@@@@.....@..
@.@..@@.@.@@@.@@...@
..@.@.@....@.@.@.@..
.@..@..@@.@@.....@@@
@.@..@..@....@.@....
....@@@...@@.@@@.@@@
@.@@.@@.@..@@...@@@@
.........@....@.@@@@
.@@.@.@.@@@.@.@@@@@@
13
18 7 0
7 18 0
7 15 0
16 1 0
19 5 0
12 14 1
3 10 1
11 7 1
8 7 1
0 19 2
9 0 2
4 15 2
12 16 2

1 11 0
5 7 0
18 3 0
0 10 0
15 4 0
3 7 1
19 7 1
15 5 1
6 1 1
0 18 2
12 7 2
6 5 2
7 5 2
