width 20
height 20
...@.@.@.@@@.@.@.@.@
@@..................
...@@@.@@.@.@.@@.@.@
.@.@@.@....@..@@..@@
..@.....@.@@.@@@.@..
.@..@.@..@.@.@@....@
@..@.@.@....@@@.@@..
@@...@.@.@.@...@.@.@
...@....@@@..@...@..
@.@..@.@.@.@@@.@.@.@
.@..@..@.......@....
...@..@@.@.@.@.@.@.@
.@.@.@@...@...@.@@@@
.@@.@.@.@@@@.@@.@@@@
.@@.......@@.....@@@
@...@.@.@...@@.@...@
..@@...@..@...@@.@.@
@..@.@.@.@@@.@...@..
@.@.@.@.@.@.@@@@.@.@
.............@...@@@
13
8 17 0
3 14 0
19 10 0
4 0 0
13 14 0
6 16 1
11 8 1
0 8 1
0 5 1
18 0 2
2 12 2
18 18 2
16 2 2

13 10 0
9 2 0
6 14 0
1 18 0
1 6 0
17 5 1
3 9 1
3 4 1
1 15 1
16 1 2
14 9 2
0 10 2
12 4 2
