width 20
height 20
..@@@....@...@.@....
.@@@@@@@..@@...@.@@@
..@.@.@@.@@@@@......
@.........@@..@.@.@.
..@.@@@.@..@@..@...@
@.@@@..@..@.@.@..@@@
@@.@..@.@.....@.@.@@
@@..@....@@.@......@
.@@...@.@.@@@@.@@.@.
....@@......@..@....
@@.@..@@.@.@@.@@.@.@
@.@@.@.@@..@.@.@..@@
..@..@..@@.......@.@
@.@@.@.@.@.@.@.@....
.....@.@.@@.@@@..@@@
.@.@@@....@..@.@.@@@
..@@@@@@.@..@....@@@
.@.@.@.....@@@@@..@@
.......@.@.......@@@
.@.@.@..@@@@@@@.@@@@
13
15 5 0
16 9 0
13 12 0
17 2 0
10 17 0
6 12 1
19 8 1
7 12 1
9 3 1
1 13 2
0 12 2
2 14 2
16 14 2

17 8 0
17 6 0
15 7 0
18 0 0
0 9 0
7 15 1
4 12 1
8 18 1
1 5 1
17 9 2
16 18 2
5 10 2
6 0 2
