width 20
height 20
.@@.@.@.@......@@@@@
..........@@@@.@@@@@
@.@.@.@.@.@...@@@@@@
...@@@@..@.@@..@@@@@
@.@@@.@.@..@..@.@@@@
...@...@..@.@.....@@
@.@.@.@.@....@@.@..@
..........@.@.@@..@@
@.@.@.@@.@.......@@@
@@...@..@@.@.@@.@.@@
@@@.@.@.@.@.@.@....@
@@......@.@.@...@.@.
@.@.@.@......@.@....
...@@@@@.@.@..@@@.@.
@.@.@.@.@@@@.@@@@@@.
..........@.....@@@@
@.@@.@.@@..@.@@..@@@
.@....@@@.@.@...@.@@
...@.@@@@.....@...@@
.@..@@@...@@@..@.@@@
13
1 4 0
15 10 0
11 6 0
15 17 0
15 6 0
12 14 1
6 1 1
13 18 1
12 0 1
1 13 2
11 10 2
0 13 2
3 6 2

10 8 0
3 17 0
12 0 0
12 15 0
16 18 0
4 7 1
13 11 1
17 11 1
14 19 1
8 15 2
10 3 2
3 6 2
1 6 2
