width 20
height 20
.@@@@@@..@@.@.@.@@@@
..@@@@..@.......@@@@
.@.@...@.@@.@@@.@@@@
....@@.......@@@.@@@
@@.@..@.@.@.@.@@..@@
....@....@.@.....@.@
@.@...@.@....@.@....
@@..@@.@@@@.@.@.@@.@
@..@@...@.@.@...@.@@
.@.@.@@.@.....@....@
..........@.@@@.@.@.
.@.@.@.@.@.@@@@@....
@...@.@@@@..@...@.@.
@@@...@@@..@.@.@@@..
@.@.@@.@.@......@@@.
@.@........@@.@.@...
....@.@.@.@@.@@..@.@
@@.@.@.@@.@.....@..@
@@@........@.@@.@@..
@@@@.@.@@.@@@@..@..@
13
16 4 0
6 3 0
14 19 0
5 4 0
2 8 0
9 15 1
10 11 1
3 5 1
9 1 1
12 6 2
11 4 2
11 9 2
15 17 2

4 2 0
4 10 0
7 18 0
0 10 0
17 19 0
11 12 1
8 15 1
18 17 1
5 13 1
15 5 2
2 2 2
12 9 2
18 15 2
