width 20
height 20
@.......@..@....@@@@
.@.@.@@..@...@.@@@@@
....@@@@...@@.@.@...
@@.@@@@@.@@.......@.
@...@@@.....@@.@@.@@
@@@@....@@.@.@@.@...
@@@@@.@..@@@......@.
@@@@@@..@..@.@.@.@@.
@@@@@@@...@..@@@@...
@@@@@@.@.@@@.@.@.@@@
@@@@......@......@.@
@@@@@.@@@.@.@.@@...@
@@@@@...@.@..@@@.@..
@@.@.@@@.@.@@.@.@@.@
.......@............
.@.@.@...@@@.@.@.@.@
@@@...@.@.....@@@...
@@@@.@..@@.@.@.@@@.@
@@@@@@@.@@@@....@..@
@@@@@@@..@@..@.@@@..
12
16 3 0
11 19 0
7 7 0
15 3 0
1 2 1
13 13 1
10 2 1
18 10 1
9 4 2
2 2 2
16 15 2
15 10 2

7 19 0
2 2 0
17 6 0
2 14 0
0 14 1
17 5 1
12 8 1
4 10 1
11 1 2
6 14 2
8 4 2
4 16 2
