width 20
height 20
@@@@@@@@@@..@@@@..@.
@@@@@@@@..@..@@@@.@.
@@@@@@@..@.@..@.....
@@@@@@@@.....@.@@.@.
@@@@@@@.@@.@.......@
@@@@@@..@.@.@.@.@@..
@@@@@.@........@@@.@
@.@@@...@.@@@.@.@.@@
...@..@@..@..@@....@
@.@.@.@..@.@....@.@@
.......@@....@@..@..
@.@.@.@.@@.@..@.@..@
..@@....@...@.@...@.
@..@@.@.@@.@.@.@@.@.
@.@.@..@@@.@........
..@..@@.@@..@.@.@.@.
@..@.......@.@@@@@..
@@...@.@.@....@.@@@.
@..@..@@..@.@....@.@
@@..@.@..@@@..@@....
12
8 16 0
0 15 0
19 0 0
0 10 0
14 9 1
19 12 1
19 10 1
9 5 1
12 13 2
7 4 2
7 6 2
15 10 2

8 8 0
1 12 0
11 8 0
14 13 0
1 13 1
12 3 1
14 9 1
2 17 1
1 18 2
16 8 2
19 0 2
5 10 2
