width 20
height 20
@.@@....@@...@@@@@@@
.....@@...@.@.@@@@@@
@.@.@@@.@......@@@@@
..@.@@.@.@@.@.@@@@@@
.@.@.....@.@....@@@@
.....@.@....@.@.@@@@
.@.@..@..@.@.@.@.@@@
..@@@.@@..@......@@@
.@.@@@@..@@@.@@.@@@@
....@...@@@..@@@@@@@
.@.@@@.@.@..@@@@@@@@
.@..@......@.@@@@@@@
.@.@.@@@.@....@@@@@@
@....@@@@@.@.@@@@@@@
@@@.@@@@...@..@.@.@@
@@@..@@@@@.@@.@.....
@@@@@@@@@@@.@.@.@@.@
@@@@@@@@@@@......@@@
@@@@@@@@@@@@.@@.@.@.
@@@@@@@@@@@@.@......
12
9 14 0
11 12 0
11 2 0
15 16 0
3 9 1
0 8 1
12 18 1
8 7 1
7 0 2
0 6 2
0 7 2
6 10 2

7 8 0
15 5 0
12 7 0
6 0 0
19 15 1
13 14 1
15 7 1
8 12 1
0 6 2
9 7 2
12 6 2
7 2 2
