width 20
height 20
.@.@.........@@.@@.@
.@..@.@@.@.@........
...@....@@@.@.@.@@.@
.@@@@.@.@@..@@.@@.@.
.@.@.@..@..@.@.@....
.....@@...@......@.@
.@.@....@..@@@.@..@@
.@..@@.@..@.@.@.@.@@
@.@...@.@.........@@
..@.@....@@.@.@@.@.@
@..@..@@@@@@.@......
..@@@@..@......@.@.@
@..@.@.@.@.@.@..@@..
..@.........@@.@@@@.
@.@.@.@@.@.@@.@@@@@@
.....@@@@.@@..@@@@@@
@.@.@@@.@.@.@.@@@@@@
@..@@@....@....@@@@@
..@.@.@.@...@.@@@@@@
@........@.@...@@@@@
12
12 5 0
6 17 0
0 1 0
16 9 0
2 10 1
0 13 1
7 0 1
3 7 1
6 12 2
9 15 2
12 12 2
9 5 2

2 7 0
5 0 0
2 10 0
7 19 0
18 1 1
14 3 1
9 18 1
15 2 1
16 10 2
11 17 2
3 9 2
1 9 2
