width 20
height 20
@@@@@@..@.@@.....@@@
@@@@...@...@@.@.@@@@
@@@..@...@.@@..@@@.@
@@..@@@@..@..@..@...
@@@@@@.@.@.@...@.@.@
@@@.@........@......
@@....@.@@@@@@.@.@.@
@@@.@..@..@...@.@@.@
@@@..@...@.@@.......
@@@.@@@@.@..@.@@.@.@
@@@@@@@...@.....@@@.
@@@@....@..@@.@..@@.
@@@@.@.@..@@@@..@.@.
@.@@@@@@@.@@@@@...@.
.....@@@...@@@..@.@.
.@@.@@..@@..@@@@....
@.@.@.@.@.@.@@@.@@.@
.............@.....@
@@.@.@@.@.@.@..@.@..
@...@@@.@@@@@@.@..@.
12
19 13 0
6 8 0
14 4 0
17 12 0
11 7 1
12 10 1
19 19 1
19 18 1
10 11 2
18 18 2
18 17 2
8 1 2

11 3 0
17 19 0
18 5 0
0 15 0
8 3 1
2 14 1
13 2 1
17 12 1
13 10 2
2 3 2
11 16 2
7 10 2
