width 20
height 20
@@@@@........@@@@@@@
@@@@@@.@.@.@..@@@@@@
@@@@@...@.@@.@.@@@@@
@@....@@.......@@@@@
@@@.@..@@.@.@@..@@@@
@@@.@.@@.@.@.@.@..@.
.@.@.@...........@..
.......@.@.@.@.@@.@.
.@.@.@.@.@..@..@....
.@@.@.@.@.@@@@@..@.@
..@.......@.@@.@..@@
.@@.@.@@@........@@@
..@..@@..@.@.@.@.@@@
@...@@.@.@@@@@@.@.@@
..@.@.........@.@..@
@..@.@.@.@@@@@....@.
@@......@.@.@.@@.@@.
@@@.@.@........@..@.
@@@@..@.@.@.@.@.@.@.
@@@..@..@@@@........
12
19 15 0
0 6 0
1 10 0
3 14 0
8 14 1
2 7 1
16 17 1
10 5 1
19 16 2
5 2 2
14 19 2
8 7 2

12 11 0
4 10 0
19 5 0
14 11 0
11 4 1
5 10 1
15 9 1
0 12 1
10 3 2
8 6 2
10 0 2
13 1 2
