width 20
height 20
@@@@@....@..@..@.@..
@@@@@@.@@.@..@.@...@
@@@@@.......@@...@..
@@@@@@.@.@@....@.@.@
@@@@@@.@.@.@@@@.@...
@@@@@@@.@....@...@.@
@@@@@@...@.@.@.@....
@@@@@..@.@@...@..@@.
@@@@@@..@.@@.@.@.@.@
@.@.@..@............
.....@..@@.@.@.@.@.@
@.@.@@.@.@@.@...@@..
@@...........@.@...@
@@@.@.@.@@.@..@@@@..
@@@..@@..@.@.@.@.@.@
@@.@.@..@.@.........
@@...@.@....@@.@.@.@
@@@.@@@@.@.@@@@@@...
@@...@@@@@...@@@@@.@
@@@.@@@@@@@.@@@@...@
12
16 7 0
16 16 0
13 11 0
11 18 0
6 12 1
7 14 1
4 12 1
18 15 1
3 10 2
1 11 2
9 16 2
19 11 2

14 0 0
13 0 0
11 19 0
6 0 0
12 18 1
16 2 1
18 17 1
3 17 1
8 0 2
3 12 2
12 3 2
19 11 2
