width 20
height 20
.@..@...@...@..@.@.@
...@.@.@..@.@.@@...@
.@.......@.....@.@..
@@.@.@.@.@@.@@..@.@.
....@...@@@@...@@...
.@.@.@.@@@@@@.@.@.@.
@.....@@@@@@.......@
@@.@.@@@@@@@@.@.@@..
@...@@@@@@@@@@@@@@@.
@@.@@@@@@@@@@@@@@@@.
@@@@@@@@@@@@@@@@@@@@
@@@@@@@@@@@@@@@@@@@@
@@@@@@@@@@@@@@@@@@@@
@@@@@@@@@@@@@@@@@@@@
@@@@@@@@@@@@@@@@@@@@
@@@@@@@@@@@@@@@@@@@@
@@@@@@@@@@@@@@@@@@@@
@@@@@@@@@@@@@@@@@@@@
@@@@@@@@@@@@@@@@@@@@
@@@@@@@@@@@@@@@@@@@@
12
12 4 0
4 1 0
5 4 0
4 3 0
19 7 1
8 2 1
1 4 1
6 1 1
18 4 2
18 6 2
4 5 2
1 1 2

2 2 0
15 6 0
16 2 0
2 7 0
13 7 1
19 4 1
5 2 1
2 8 1
9 0 2
2 6 2
15 5 2
0 0 2
