width 20
height 20
@@@@.@@..@@@.@.@.@.@
@@@....@............
@@.@.@..@.@@.@.@@.@.
......@.@.@@.@.@@@..
@.@@.@.@@@.@@.@.@@.@
..@....@@..........@
@..@.@.@.@.@.@.@.@..
.@@.@.....@..@..@..@
..@...@.@..@..@@.@@.
.@..@@.@..@.@....@..
...@....@...@.@@@@.@
@@...@.@@.@@....@...
..@@.@@..@..@.@...@.
@..@.@.@.@.@.@@@.@.@
@@...........@@@....
@@@.@.@.@@.@...@@@.@
@@@@@@@@...@@.@.@..@
@@@@@@@@@.@.......@.
@@@@@@@@@@..@.@.@...
@@@@@@@@@..@@@...@.@
12
0 12 0
0 8 0
14 9 0
16 12 0
11 12 1
12 15 1
8 14 1
5 14 1
16 14 2
7 0 2
12 14 2
6 6 2

16 8 0
18 10 0
1 10 0
6 6 0
8 9 1
7 12 1
14 1 1
13 10 1
4 2 2
7 2 2
9 14 2
17 17 2
