width 20
height 20
..@@@..@..@.@.@.@.@.
.@@@..@@@.........@.
..@.@.@@@@.@.@.@.@..
.@........@@..@....@
...@@.@@@@...@@@.@..
.@@@.@@...@.@...@@.@
.....@@@.@.@.@.@....
.@.@..@.........@@.@
..@@@..@.@@.@.@.@...
@..@.@.....@@..@@@@.
..@@...@.@..@.@@@...
@.@..@@@@@@..@.@.@.@
..@@.@.@.@.@@......@
@@@...........@.@@.@
.@@@@.@@.@.@@.@@..@@
........@....@...@@@
@.@.@.@.@@.@@.@.@@@@
@@@@...@.........@@@
@@@@@.@@@@.@.@.@.@@@
@@@@@..@@@@...@..@@@
12
4 12 0
0 2 0
15 16 0
15 1 0
6 0 1
18 11 1
12 6 1
5 3 1
17 1 2
8 13 2
18 13 2
6 19 2

4 6 0
0 15 0
6 8 0
11 13 0
9 3 1
0 10 1
18 11 1
12 17 1
12 13 2
16 19 2
1 11 2
8 0 2
