width 20
height 20
....................
.@@.@@.@@.@.@.@.@.@.
.@.@@.@@.@...@.@...@
.......@..@.@@..@.@@
.@.@@@.@.@.@@@@...@@
.@.@.@......@.@@@.@@
..@....@.@.@@.@..@@@
.@..@.@@.@@.@...@.@.
..@..@@@@...@@@.....
@..@..@...@.....@.@@
@@@@.@..@.@.@@.@@@@@
@.....@@@.@.@.@...@@
..@@.@..@@......@...
@.@.@.@...@.@.@.@.@.
@.@.....@..@@@@@@@..
....@.@@.@@.@.@.@.@.
.@.@...@............
..@@@@...@@.@.@.@.@.
.@.@@@@.@@@@...@@..@
....@@@.@@@@@.@@@@..
12
19 0 0
3 7 0
11 16 0
11 12 0
17 8 1
18 8 1
15 1 1
7 19 1
6 0 2
17 2 2
14 18 2
0 3 2

5 6 0
10 12 0
11 13 0
0 17 0
17 4 1
19 8 1
6 1 1
7 18 1
4 9 2
3 14 2
16 8 2
5 3 2
