width 20
height 20
@...@...@..@.@...@..
.@.@.@.@.@.....@..@.
...........@@.@.@...
@@.@.@@.@.@@.@@.@@.@
@@..@@@..@@........@
@@.@...@@..@.@.@@.@@
@....@@@@.@@@@...@..
@@.@..@@@..@@.@.@.@.
@.@..@...@..........
..@.@.@.@..@.@@.@.@.
@.......@@.@.@@@.@@.
..@.@.@@@.@.@@@@..@.
@..@.@@.@.....@@@...
..@..@....@.@..@@@.@
@...@@@.@.@@..@.@@.@
..@..@...@..@.....@@
@.@@..@.@@@.@@.@@.@.
@@@.@.@.......@.....
........@@.@.@@@.@.@
@.@.@.@.@@@@@@@@@...
12
10 17 0
2 2 0
0 2 0
2 14 0
12 12 1
4 7 1
11 15 1
13 7 1
13 13 2
3 0 2
9 3 2
8 2 2

3 4 0
16 4 0
19 16 0
15 6 0
0 18 1
5 18 1
10 0 1
11 12 1
1 0 2
16 15 2
15 17 2
13 1 2
