width 20
height 20
.@@....@...@.@@@..@@
.@.@@.@.@.@....@.@.@
..........@.@@......
.@.@.@.@@.@..@@@.@.@
@@..@@@@....@@@.@..@
...@@@@@.@.@.@....@@
.@@@@@@@@@@....@.@@@
..@@@.@@.@.@.@@@..@@
.@@@..........@..@.@
@.@.@.@.@.@@.@@@.@..
......@@@@....@@@.@.
@.@.@@@@@@@@@@.@@...
@@@..@@@@@.@@.....@.
@@@.@@@.@@..@.@@@@@.
@@@......@.@..@.@...
@@@@@.@.@@.@@...@@.@
.@@@@.@@.@.@..@@.@..
..@@...@.....@.@.@.@
@.@.@.@..@.@......@@
........@...@@.@.@@@
12
15 14 0
4 10 0
16 3 0
0 6 0
16 17 1
13 15 1
5 10 1
10 10 1
3 4 2
18 11 2
18 1 2
3 10 2

17 4 0
0 8 0
16 12 0
14 6 0
11 17 1
15 5 1
8 5 1
0 7 1
18 17 2
15 4 2
14 1 2
3 12 2
