width 20
height 20
@@.@@@@..@@.@.@...@.
@....@@@........@...
@@.@..@..@.@@@.@.@.@
@@..@@.@@@@@@@@....@
@@.@.@.@.@.@.@..@.@.
@.............@..@..
..@@.@.@.@.@.@@.@.@.
@...@.@...@.........
..@@..@@.@@@.@.@.@@@
@....@..@@@@@...@@@.
@.@.@@@.@@@@@@.@@@..
.@.......@@@@.@@@@@.
..@@.@.@..@.@...@...
@.@.@@@..@...@.@..@.
.....@.@...@....@..@
.@@@@....@@.@.@.@.@.
..@.@@.@..@.@@......
.@......@@....@.@.@.
..@.@.@.@.@.@@@@...@
@....@@.......@..@..
12
2 19 0
16 0 0
19 9 0
19 0 0
10 13 1
9 18 1
8 2 1
16 8 1
14 14 2
4 1 2
1 13 2
3 14 2

11 7 0
2 14 0
18 2 0
15 6 0
18 1 1
1 19 1
10 19 1
0 6 1
2 4 2
4 5 2
8 0 2
2 1 2
