width 20
height 20
@.@@@@@.@.@@@@@@@@@.
..@..@@....@@@.@@@..
@.@.@.@.@.@@@...@@@.
........@@.@.@.@.@..
.@.@@.@...........@.
..@@.@@.@@.@.@@.@.@.
@.@....@..@....@....
@@.@@.@@@..@.@.@@.@.
....@....@...@.@...@
@.@...@.@@@.@.@.@.@.
@@@.@@@@.@.@........
@@..@.@......@@.@.@.
@@@.@...@.@.@@@@.@@.
.@...@@..@@@.@.@.@.@
...@..@@..@.........
.@.@@....@.@.@.@.@.@
.@@.@@.@......@@@..@
.....@@@@.@.@@.@.@..
.@.@.@.@.@.@.@.....@
..@...........@.@@..
12
10 4 0
9 14 0
17 8 0
0 5 0
16 13 1
3 10 1
10 15 1
6 15 1
7 19 2
5 6 2
5 19 2
4 6 2

3 12 0
0 16 0
17 9 0
7 3 0
17 18 1
6 15 1
9 11 1
16 8 1
16 10 2
17 16 2
19 4 2
10 7 2
