width 20
height 20
....@.@@.......@.@.@
.@@@.....@@@.@.....@
.@@@@@.@.@..@@.@.@..
..@@..@..@.@.@.@@..@
@..@.@.@......@.@@@.
..@.....@@.@.@...@..
@...@.@.@@@....@...@
@@.@@..@.@.@.@.@.@.@
@@@.@.@....@..@.@...
@@@.....@.@..@@...@@
@@..@.@@@..@@@@.@@.@
.@@@...@.@@.@.......
.....@.......@.@@@.@
@.@.@..@@.@.@...@...
...@@.@@@@...@.@@@.@
@.@..@@@@.@.@.@@@...
....@@.........@.@.@
.@.@.@@.@.@.@.@@....
@.....@@@..@@....@.@
@@.@@@@...@@@.@.@..@
12
5 6 0
13 19 0
8 16 0
8 7 0
11 0 1
5 10 1
6 2 1
18 7 1
18 13 2
11 4 2
3 15 2
10 12 2

8 11 0
18 8 0
8 4 0
6 7 0
18 15 1
9 19 1
17 3 1
13 11 1
14 12 2
17 11 2
3 13 2
12 3 2
