width 20
height 20
@.@..........@@@...@
....@@@.@.@@@.@.@.@.
@.@..@@@@@.@@.......
@.@.@.@.@....@.@.@@.
..@.......@.@@.@..@.
@.@.@.@.@..@@.@.@@..
@@..@@@@..@@.....@.@
@@@...@.@...@.@@....
@.@.@@....@@.@...@.@
...@@@@.@@@@...@.@..
.@@@@@..@.@.@@..@@@@
..@@@..@.......@.@@@
.@.@.@.@@.@.@@....@@
..........@@.@.@@@.@
.@.@@.@.@.@...@@@...
@...@@.@.@.@.@@@.@.@
.@@.................
....@.@.@.@.@.@.@@@.
.@.@...@.@...@@@....
.@..@.@@...@.@@@@.@.
12
11 14 0
3 0 0
5 5 0
13 16 0
12 16 1
7 9 1
16 0 1
18 8 1
4 13 2
1 17 2
15 16 2
8 18 2

19 5 0
11 17 0
16 8 0
15 16 0
18 8 1
18 18 1
4 4 1
13 17 1
4 13 2
12 15 2
3 16 2
0 10 2
