width 20
height 20
.@.@@@@@@@@@@@..@..@
....@@@@@@@@@.@.@.@@
@@.@.@@@@@.@........
@.....@@@....@@.@@.@
@.@.@@.@@@.@...@.@.@
.@..@...@@@..@....@.
..@.@.@@.@.@@.@@.@@.
@...................
..@@.@.@.@.@.@.@.@.@
@.@.@.@@@@@..@.@@..@
.......@.@.@@.@@.@@.
@.@.@@..............
..@..@@.@@@@@.@.@.@.
@..@.@@.@@@@...@@@..
@.@...@...@.@.@@@@.@
.@.@.@@@.@@.@..@@...
....@.@.@.....@@@@.@
.@.@@....@@@@@..@@.@
..@.@.@.@.@.@.@.....
@.....@.........@@@.
12
6 4 0
8 6 0
2 19 0
11 7 0
1 18 1
2 7 1
2 5 1
14 8 1
16 18 2
2 15 2
7 7 2
15 7 2

3 18 0
18 9 0
16 2 0
1 19 0
13 11 1
8 15 1
16 18 1
13 19 1
13 6 2
16 8 2
3 19 2
15 19 2
