width 20
height 20
.@@...@.@@.@.@.@.@@@
.@.@.@@...........@@
........@.@.@@.@.@@@
@@.@.@.@.@.@..@..@@@
@@@.@.@@.....@@@.@@@
@@@...@@@.@@..@...@.
@@.@.@.@.@.@.@@@.@..
@.............@....@
..@.@.@@.@.@@..@@@..
.@.@....@@@...@@@..@
.@..@.@@....@@@..@..
...@.@@.@@.@....@.@.
@.@......@..@.@.....
....@.@.@.@@.@..@.@.
@.@..@@........@.@@@
@@..@@@.@@.@.@......
@@@.@.....@...@.@@.@
@@@@@@.@.@@@.@.@@...
@@@@@@@@@@@@.....@@.
@@@@@@@@@@@@@.@.@@..
12
15 13 0
13 3 0
13 5 0
3 7 0
10 1 1
8 8 1
17 15 1
3 2 1
4 6 2
12 18 2
16 18 2
10 11 2

10 4 0
18 8 0
6 7 0
1 13 0
3 16 1
16 6 1
1 11 1
17 13 1
11 16 2
7 2 2
5 4 2
14 1 2
