width 20
height 20
...@....@@@@@@@.@@@@
.@...@.@@@@@@@...@@@
.@.@@....@@.@.@.@@@@
@@..@.@.@.......@@@@
.@.@.@.@@@.@.@.@@@@@
.......@@@@...@@@@@@
@@.@@@.@@@@@.@.@.@@@
..@@@..@@@........@.
.@.@.@..@.@@.@.@.@..
.......@......@@@.@.
.@.@@.@.@.@.@.....@.
.@..@@....@@..@.@...
@.@.@.@.@..@.@@@@@@.
@......@..@.@.@.@@@@
..@.@.@@@.@......@.@
@..@@@@.....@.@.@...
@.@.@.@@@.@..@....@.
...........@@@@@@..@
.@.@.@.@@.@@.@.@@@..
..@...@..........@.@
12
0 4 0
4 9 0
11 19 0
11 15 0
14 18 1
3 17 1
0 5 1
0 2 1
10 7 2
4 5 2
3 3 2
1 16 2

19 9 0
16 1 0
1 0 0
15 11 0
0 4 1
6 17 1
8 11 1
1 17 1
19 11 2
17 10 2
12 3 2
13 10 2
