width 20
height 20
@@@@@@@..@....@@....
@@@@@@..@..@.@.@.@.@
.@@@@.@.@@..@.....@@
...@.......@.@.@.@@@
@.@.@.@.@@......@@@@
.......@@@@.@.@@@@@@
.@.@.@@@@@.@@@@@@@@@
..@@@@@@@...@..@@@@@
.@.@.@.@.@.@.@.@.@.@
...............@.@.@
.@.@.@.@.@.@.@......
..@.@@@.@.@@@@.@@.@.
@.@.@.@.@..@..@..@..
@@....@..@..@.@.@.@.
@@@.@...@@@...@.....
@@@@..@..@..@.@.@.@.
@@@@.@.@@..@.....@@.
@@@....@.@@.@.@.@@@@
@@.@.@......@..@@@@@
@.....@@@.@...@@@@@@
12
6 9 0
11 7 0
10 10 0
6 18 0
3 19 1
1 4 1
19 0 1
2 6 1
4 3 2
10 6 2
11 18 2
8 15 2

13 17 0
8 10 0
13 15 0
10 2 0
14 11 1
14 18 1
16 0 1
10 12 1
16 16 2
14 9 2
5 4 2
0 2 2
