width 20
height 20
@@@@...@..@@.@..@@.@
@@@@@@.@.@@....@.@..
@@@@@.....@@.@.....@
..@@.@.@.@@.@.@.@@..
.@@.....@@..@.@@.@.@
.@.@.@@@@@@.........
.........@..@.@@.@@.
.@.@@@.@@.@..@..@@.@
..@...@@@...@.@.....
.@..@..@@.@.....@@.@
...@.@@.@..@@.@@@...
@@...@....@@@@.@.@.@
@.@@.@.@.@@.........
..@.....@@..@.@@@@@.
@.@@.@.@@@@.@...@..@
...@..@@@@@@..@...@@
@@...@.@@@..@.@.@@@@
...@......@...@...@@
.@..@@@.@..@@..@.@@@
..@.@@..@.@@..@...@@
12
10 6 0
5 9 0
4 5 0
12 19 0
16 17 1
15 9 1
2 18 1
10 8 1
0 8 2
1 3 2
3 16 2
15 12 2

8 11 0
0 5 0
0 15 0
18 7 0
11 6 1
11 14 1
11 1 1
18 1 1
0 10 2
19 8 2
3 16 2
1 3 2
