width 20
height 20
@@.@..@..@@@@@@@@@@@
.@...@..@@@@@@@@@@@@
...@...@@@@@@@@@@@@@
.@.@.@..@@@@@@@@.@@@
..@@@.@...@@@@@....@
@@.....@.@@@@@.@.@.@
@.@.@@.....@......@@
...@.@.@.@..@.@@.@@@
.@......@..@....@.@@
@@.@.@.@@@..@.@....@
....@@@@@@.@@@@.@.@.
@@.@.@.@@.@.@..@..@.
@...........@@..@...
.@@@.@.@@.@.@.@.@.@.
...@..@...@......@@.
.@..@@..@..@.@.@....
@.@.@.@..@@...@.@.@.
........@@@@.@....@.
.@@@.@.@@@@@@.@.@..@
....@@@@@@@@.....@..
12
6 12 0
17 4 0
17 17 0
6 9 0
14 5 1
16 6 1
11 7 1
8 14 1
4 9 2
12 6 2
10 7 2
12 16 2

4 8 0
9 11 0
15 6 0
7 12 0
0 4 1
15 13 1
2 2 1
18 4 1
15 9 2
5 2 2
18 5 2
16 17 2
