width 20
height 20
@@@@@@@@@@@@........
@@@@@@@@@@...@.@.@.@
.@@@@@@@@.@.@..@@...
..@@@@.@.....@@.@@.@
.@.@@@.@@.@@@.@.@...
....@...@........@.@
.@.@.@.@@.@.@@@.@.@@
..@..@...@@@@......@
.@@.@..@...@.@.@@.@@
.....@@@.@......@..@
.@@.@.@...@@@@.@@.@@
.@@....@.@.@.@.@.@@@
@...@.@......@@.....
@@.@.@@@.@.@.@.@.@.@
@.....@..@@@......@@
@@.@@.@@..@..@@@.@@@
@.@@...@@@.@...@..@@
...@@.@.@@.@.@@.@@..
@@.................@
...@.@.@@@@.@.@@.@..
12
11 2 0
17 0 0
15 3 0
6 11 0
11 1 1
1 17 1
12 0 1
17 6 1
15 12 2
16 14 2
8 12 2
4 11 2

16 19 0
0 5 0
12 3 0
18 1 0
7 5 1
17 7 1
9 8 1
12 11 1
17 14 2
2 14 2
18 13 2
9 4 2
