width 20
height 20
@.@@.@.@.@.@@@@@@@..
@...........@@@@@..@
.@@@@.@.@@.@@@@@.@..
.......@@...@@.....@
@.@.@.@..@.@.@@.@@..
...@....@.....@@.@.@
@.@.@@.@..@@.@@@....
@@..@.@@@.@...@..@@@
@@@....@.@.@.@.@.@.@
@@@@@@..............
@@@....@.@.@@@.@@@.@
.@.@.@.@@@....@..@..
......@@@@.@.@@@...@
.@.@.@.@@@..@@@@@@.@
..@@.@....@..@@@@@..
.@.@.@.@.@@.@@@@@..@
....@...@@@@@@@.@@..
.@.@.@.@.@@@@@...@.@
@.........@@@@@@....
..@@@.@.@.@@@@@@.@.@
12
0 13 0
6 6 0
1 5 0
8 10 0
1 12 1
7 9 1
6 13 1
19 4 1
10 4 2
9 6 2
1 16 2
7 16 2

16 7 0
9 18 0
13 5 0
19 11 0
9 1 1
5 8 1
8 8 1
17 1 1
1 4 2
10 12 2
0 3 2
1 14 2
