width 20
height 20
@@@@@@@@@@..@...@..@
@@@@@@@@@@@.@@@...@.
@@@@@@@@@@@...@.@...
@@@@@@@@.@.@.@.@..@.
@@@@@@@........@.@.@
@@@@@@.@.@.@.@.....@
@@@@@...@@..@.@.@@.@
@@@@..@...@....@....
@@@@@..@.@.@@.@.@.@.
@@@@@@@....@@@..@..@
@@@@@@.@.@..@@.@.@..
@@@@@...@@@........@
@@@@@.@..@@@.@.@@.@@
@@@@@@..@.@.@.@....@
@@@@@.@.@.......@.@.
@@@.......@.@.@..@..
@@@.@.@.@..@@@..@.@.
@@@@@@..@@.@@.@.....
@@@@@..@..@.....@.@.
@@@@@@...@@@.@.@@@..
12
8 8 0
11 13 0
17 7 0
8 7 0
7 14 1
7 13 1
10 14 1
11 10 1
9 14 2
15 11 2
7 11 2
12 7 2

17 5 0
11 0 0
8 5 0
4 7 0
13 7 1
13 14 1
15 6 1
17 13 1
7 14 2
8 4 2
11 2 2
10 5 2
