width 20
height 20
@.@@...@.@@.@.@.@.@@
...@@.@.............
@.@@...@@.@.@.@.@.@.
....@@.@.@@@...@.@@.
@.@@......@@@.@@.@.@
.....@.@.@.@@.......
@.@@..@.....@@.@.@@.
@@.@.@@@.@.@...@.@@.
@.....@@@...@.@..@.@
.@.@.@@@@@.@@@@@...@
..@...@@@@..@.@.@@.@
@.@@.@.@.@.@........
..@.......@..@.@.@.@
@..@.@.@.@.@..@..@@.
.@.@..@......@.@.@..
...@@@.@.@.@@....@.@
.@@.@.....@..@.@....
.@....@@.@.@....@.@.
...@@...@....@.@@@..
@@...@@.@.@@..@@@@@.
12
6 11 0
12 14 0
17 9 0
11 14 0
11 10 1
8 5 1
11 16 1
16 12 1
14 11 2
12 1 2
13 13 2
0 1 2

0 1 0
0 12 0
1 13 0
19 2 0
8 3 1
15 1 1
9 8 1
13 7 1
12 11 2
7 19 2
12 13 2
3 3 2
