width 20
height 20
......@@.@@@@@@@@@@@
.@@@.@....@@@@@@@@@@
@.@@.@.@@...@@@@@@@@
...@.....@.@@@@@@@.@
.@@.@.@.@.@@@@@@@@..
.....@....@@@@@@@..@
@.@.@@@@@..@@@@@.@.@
.@...@@...@@@@@.....
.@@.@@@@.@.@@@.@.@@.
....@@@.....@....@.@
.@.@@@@@@.@.@.@@....
..@@@@@@@@.....@.@.@
@..@@@@@.@@.@.@.@..@
..@.@@@..@@@.....@@.
@.....@@....@.@@....
..@.@....@.@@.@@@.@.
.@@@..@.@....@.@@@..
@...@@@@@@.@...@@.@.
.@.@@.@.@.@..@......
............@..@@@.@
12
11 11 0
7 4 0
18 10 0
1 17 0
8 5 1
10 11 1
1 6 1
13 13 1
11 19 2
7 1 2
6 1 2
15 9 2

16 10 0
0 13 0
18 4 0
2 9 0
3 7 1
1 9 1
12 16 1
2 0 1
15 18 2
11 9 2
16 8 2
4 14 2
