width 20
height 20
@@@..@@@@...@....@..
@@@.@@@@.@.@..@.@.@.
@@..@@@......@.@....
@@.@@@@@.@@@.....@@.
.@.@.@@@@.@@@.@.@@@.
...........@@@@@@@..
.@.@.@.@.@..@.@.@.@.
..@.@..@.@.@........
.@@...@@@....@.@.@@@
.@..@..@@@@@.@@@....
..@..@..@..@@@@@.@.@
@.@.@..@@@...@..@@..
...@@@.@@@@.@.@....@
@.@@@@@.@@......@.@.
...@@@.....@@.@..@@.
@.@@@@.@@@.@.@.@@@..
@@@@@@....@@......@.
@@@@@@.@@....@.@.@..
@@@@@@@...@.@@@....@
@@@@@@@@.@..@@@@.@..
12
9 16 0
0 12 0
8 16 0
10 8 0
19 4 1
0 7 1
6 9 1
6 10 1
8 14 2
11 0 2
1 15 2
7 16 2

19 13 0
19 15 0
16 9 0
6 12 0
5 5 1
8 6 1
3 7 1
7 10 1
1 15 2
17 2 2
0 5 2
7 5 2
