width 20
height 20
@..@@.@..@....@@@@@@
@.@@....@.@.@.@@@@@@
...@@@@......@.@@@@@
@.@.@@@.@.@.@@..@..@
@.@..@...@@@@..@.@..
....@.@.@.@..@.....@
@.@...@.....@.@@.@@@
@@@@@..@@@@.......@.
@@@.@.@.@@@@.@.@@.@.
..........@@@.@@@...
@@@.@@.@@..@..@...@.
@.....@@@@@.@..@@..@
.@.@@@.@@.@...@.@.@.
.@.@@.......@.......
......@.@.@@@@.@.@@.
.@.@.@@@@@@@@@@@@...
..@.....@.@@.@.@@.@.
@..@.@@.@.......@@..
..@@@....@.@.@.@@.@.
@..@@@@.@...@.......
12
15 17 0
1 14 0
11 13 0
11 11 0
9 14 1
16 6 1
1 17 1
16 10 1
9 17 2
17 18 2
4 11 2
1 11 2

3 4 0
12 18 0
3 6 0
14 14 0
11 0 1
17 3 1
0 14 1
13 9 1
11 7 2
1 6 2
5 5 2
13 19 2
