width 20
height 20
@@@@@@@...@..@..@...
@@@@@@..@@@.@.@.@.@@
@@....@..@..........
.@@@.@.@..@@.@@.@.@.
.......@.@.@...@@..@
@.@@.@.....@.@.@..@.
@@@@@..@@@.@@@@@@...
@@@@..@....@.@.@.@@.
@@@@@..@.@........@.
@@@@@@@@@@.@@.@.@...
@@@@@@@@..@@.@@@..@.
@@@@@....@....@@@@..
@@@@..@@..@@.@@.@.@.
@@@..@...@@.........
@@@@..@.@.@.@.@.@.@.
@@@@.@@......@@@@@@@
@@@@@@..@.@.@.@.....
@@@@@@@.@@....@.@.@.
@@@@@@@@@@@.@....@@@
@@@@@@@@@@@@@.@@....
12
19 5 0
13 19 0
12 2 0
10 4 0
16 18 1
4 2 1
11 8 1
13 16 1
17 17 2
13 2 2
8 2 2
14 0 2

10 6 0
19 16 0
18 6 0
3 13 0
6 3 1
9 14 1
10 4 1
14 8 1
0 3 2
17 9 2
18 16 2
13 11 2
