width 20
height 20
@@@@@@@@@@@@@@......
@@@@@@@@@@@@@@@.@.@.
@@@@@@@@@@@@@@..@@..
@@@@@@@@@@@@@.@.@.@.
@@@@@@@@@@@.......@@
@@@@@@@@@@@@.@@.@.@.
@@@@@@@@@.@...@@....
@@@@@@@@@.@.@@.@.@.@
@@@@@@@@..@@.....@.@
@@@@@@@.@...@.@.@...
@@@.@.@.@.@@.@...@.@
@@....@.......@.@@@@
@@@.@...@.@.@@......
@@...@.@@@..@@@.@.@@
@.@.@@.@...@..@.@.@.
......@@@.@.@..@....
.@@.@@.@.@....@@@.@.
.@.@.@.....@@..@@@..
...@.@.@.@.@..@.@.@.
.@......@@..@.......
12
11 6 0
6 18 0
12 5 0
16 0 0
6 12 1
17 18 1
15 9 1
9 6 1
18 9 2
13 11 2
16 7 2
14 8 2

18 17 0
19 9 0
13 19 0
6 19 0
15 18 1
1 15 1
9 15 1
11 15 1
19 16 2
19 0 2
1 14 2
11 11 2
