width 20
height 20
@.@.@.@@@@@.@@@@@@@@
..@....@@@...@@@@@@@
@...@.@.@.@.@.@@@@@@
..@.@.....@....@@@@@
@..@@.@.@...@@..@@@@
@@@@@@.@@@@.@@.@@@@@
@@@@@..@@@@@...@@@@@
@@@@@@.@.@@@@.@.@@@@
@@@@@.....@@@.@...@@
@@@@@@@.@.......@.@.
@@@@@@@@@@.@.@.@....
@@@@@@@.@.@@@@..@.@.
@@@@@@......@@.@..@.
@@@@@@.@.@.@..@.@.@.
@@@@@...@...@.@....@
@@@@@@@.@.@.....@.@@
@@@@@...@@@@@.@@.@@@
@@@@@@.@@.@.@@.@...@
@@@@@............@..
@@@@@.@.@.@.@@.@@@.@
12
18 14 0
17 11 0
5 16 0
15 4 0
11 0 1
7 8 1
10 12 1
10 14 1
14 3 2
0 3 2
1 1 2
8 12 2

6 17 0
10 4 0
13 7 0
1 4 0
15 11 1
5 3 1
11 3 1
15 8 1
18 18 2
9 8 2
14 9 2
11 18 2
