width 20
height 20
@@.@.@.@.@..@..@..@@
@..@.......@@.@.@..@
@@...@.@.@........@@
@@.@..@@@.@@@.@.@.@@
@...@@@@@.@..@..@@@@
@@.@..@.....@.@...@@
@@.@@..@.@@@....@..@
@@....@...@.@.@..@@@
@.@.@@.@@......@@..@
...@...@@@.@.@.@.@..
@.@.@@..@.@@@....@.@
....@.@.@.@.@@.@....
.@@..........@.@.@.@
@@@.@.@.@.@.@.@.@..@
@...@@@@@@@@......@.
.@@.@.@.@.@@@.@@@.@.
..............@..@..
@@.@@.@.@.@.@.@@.@.@
.....@@..@..@.......
@@@.@@@@.@@..@.@.@.@
12
12 4 0
7 5 0
12 2 0
17 15 0
7 1 1
17 2 1
1 4 1
2 0 1
14 18 2
3 16 2
6 10 2
2 3 2

8 6 0
0 11 0
15 6 0
2 4 0
0 16 1
12 8 1
5 6 1
17 5 1
17 15 2
9 5 2
18 18 2
2 2 2
