width 20
height 20
....@.@.@@.@@@@@@@@.
.@@@.....@..@.@@@@..
..@.@.@.@.@...@.@.@.
.@.....@...@@.......
..@.@.@..@.@..@.@.@.
@...@..@.@@.@.@@@@..
..@.@.@@......@.@@@.
@..@.@.@.@.@@@...@..
@.@.....@@@.@@@.@.@.
....@.@.............
@.@.@@@@@@.@@.@@.@.@
...@...@@.@..@....@.
@.@..@@@..@.@@@@@.@.
...@..@.@....@......
@.@.@...@.@.@@@@@.@.
......@...@@@@@@@@..
@@@.@..@@.@@@@@@@@@@
...@..@....@@@@@@@@@
.@@@@..@@.@.@@@@@@@@
......@......@@@@@@@
12
4 1 0
19 15 0
0 15 0
2 11 0
1 15 1
9 15 1
19 6 1
8 4 1
0 9 2
7 15 2
4 3 2
5 2 2

1 8 0
0 9 0
9 13 0
1 11 0
5 13 1
15 2 1
19 4 1
12 4 1
9 2 2
13 3 2
18 1 2
0 18 2
