width 20
height 20
@.@...@@@@.@@@....@@
....@@@@@...@..@.@.@
@.@.@.@@.@.@.@.@....
..@.............@@@.
.@@.@@.@@.@@.@@...@.
..@@..@@@@@@.@@.@@..
@@@..@@@@.@@...@..@.
@@..@.@@@.@.@.@@.@..
..@...........@..@@.
@.@.@.@@.@@.@..@...@
.....@@@@@@@.@@..@.@
@.@.@@@@@..@.@.@@...
..@@.@.@.@.....@.@.@
@..........@.@......
.@.@.@.@@.@@@@.@.@@@
..@.@.@@.@@...@.....
@.........@.@@.@.@.@
@@.@.@.@@.........@@
@@..@@...@.@.@.@.@@@
@@@@@@@.@...@...@@@@
12
12 5 0
14 1 0
18 11 0
1 12 0
15 0 1
5 13 1
2 18 1
13 15 1
3 8 2
13 9 2
8 9 2
16 13 2

8 12 0
16 0 0
12 5 0
7 8 0
3 2 1
19 2 1
6 12 1
12 3 1
3 10 2
3 18 2
2 18 2
13 9 2
