width 20
height 20
@@@@@@@@@@@@@@@@@@@@
@@@@@@@@@@@@@@@@@@@@
@@@@@@@@@@@@@@@@@@@@
@@@@@@@@@@@@@@@@@@@@
@@@@@@@.@.@@@@@@@@@@
@@@@@@.....@@@@@@@@@
@@@@@@@.@.@.@@@@@@@@
@@@@@@...@..@@@@@@.@
@@@.@.@.@@.@@@@@....
@@.........@@..@@@.@
.@@@@.@@.@....@@@...
.@.@.@.@.@@@@..@..@.
........@.@.@.@.@@..
@@.@@.@..........@@.
.@..@@..@@.@@.@.@...
...@...@@.@@.@....@.
.@.@@.@........@@..@
@@..@@.@.@.@.@.@@@.@
@@@.@.....@..@@.@..@
@@@@@@.@.@@@....@@..
12
5 15 0
2 15 0
11 7 0
9 13 0
3 17 1
1 15 1
15 19 1
7 7 1
7 16 2
0 11 2
1 12 2
8 17 2

3 17 0
13 10 0
2 17 0
12 15 0
11 13 1
7 12 1
12 16 1
3 8 1
11 6 2
12 10 2
12 13 2
9 5 2
