width 20
height 20
.....@@@@@@...@@@@@@
.@@@...@@@@@@..@@@@@
@.@@.@@.@@@...@.@.@@
@........@@@@......@
..@.@.@.@@@@@.@.@@..
@..@@@...@@@@..@@@@@
..@@@@@.@.@@.@.@.@@.
@...@@..............
..@@@@@@.@.@@.@.@.@.
@...@@.@@....@@@@@..
..@@....@@.@..@@@@@.
@....@.@@...@@.@.@..
@@.@@.@.@@.@@....@@.
@.@......@@.@.@@....
...@.@.@......@@.@.@
.@..@.@@@@.@@..@@..@
@..@@.@@@@@...@@@@..
@@.@@..@@@.@@..@@@.@
......@.@.....@.@.@@
@.@.@.....@.@.......
12
19 4 0
13 7 0
1 10 0
15 4 0
4 11 1
2 5 1
18 14 1
10 10 1
7 6 2
9 18 2
15 12 2
3 19 2

15 2 0
7 12 0
14 15 0
1 9 0
4 18 1
7 5 1
18 14 1
2 18 1
11 14 2
8 8 2
5 3 2
10 10 2
