width 20
height 20
...@.@@..@@.....@.@.
@.@..@.@...@.@@.....
...@.....@..@@@.@.@.
.@...@@.@@@@@@...@@.
@..@..@.@..@@@@.@@@.
..@.@.@@.@.@.@.@@@..
@...@..........@@.@.
..@..@.@@.@.@@....@.
@.@.@.@.@@...@.@@...
@@......@@.@@@@..@.@
@@@.@.@.@.@@.@.@..@@
@@@@@@....@......@.@
@@@.@.@@@.@@.@.@....
..@.........@.@.@.@.
@...@.@@.@.@@.@.@@@.
..@..@@.@.@.........
.@..@.@.....@.@.@@@@
..@.....@.@..@@@@@@@
.@@.@.@..@@.@@@@@@@@
..@..@..@@@@@@@@@@@@
12
7 6 0
8 1 0
19 1 0
16 15 0
7 9 1
13 11 1
12 6 1
1 4 1
6 6 2
8 14 2
8 16 2
17 8 2

15 13 0
15 0 0
13 15 0
4 2 0
3 9 1
15 14 1
18 8 1
2 3 1
11 15 2
12 1 2
6 11 2
6 19 2
