width 20
height 20
.@.@.@@@@@@@@@@@@.@.
.....@@@@@@@@.@.....
.@@@..@@@.@@....@.@.
@.@.@..@...@.@.@...@
@.....@.@.@.@.@.@.@@
..@@@..............@
@..@@@.@.@.@@@.@@.@.
..@@@@@.@.@.@.@@.@@.
.@.@.@@.............
........@.@.@.@.@.@.
@.@.@.@.@..@.@.@@@..
@@...@@@..@@.@..@.@.
..@@@.@@@......@....
@..@..@@@@.@@.@.@.@.
..@@.@@@@@@......@@@
@..@..@@@@@@@.@@@@@@
.@...@@@@@.....@@@@@
...@@.@@@.@.@.@@@@@@
.@.@........@@.@@@@@
@....@.@.@@.....@@@@
12
11 5 0
18 1 0
1 3 0
7 9 0
9 18 1
10 18 1
3 9 1
12 19 1
15 14 2
6 18 2
17 12 2
15 9 2

9 17 0
14 18 0
7 4 0
19 13 0
12 3 1
4 8 1
15 14 1
17 5 1
13 14 2
2 19 2
4 9 2
14 2 2
