width 20
height 20
@@@@.@@.@..@.@@..@..
@@.@.....@......@@.@
@@...@.@...@.@.@@...
.@.@@@@@.@@.@....@.@
.@.@@@..@.@.@@.@....
.@....@........@.@.@
.@.@@..@.@.@.@@.@@..
...@..@.@.@.@.@.@.@.
@@..@.............@.
@@@@@@.@.@.@.@@.@..@
@@.@....@@@.@@@@..@@
@....@.@@...@@@@@.@@
.@.@.@.@..@.@.@@@..@
...@@.@.@..@...@.@.@
.@........@.@.@.....
@@@.@.@.@...@..@.@.@
@@@@.@.@@.@.@.@@..@.
@@........@....@.@..
@@@@.@@.@@..@.@....@
@@@...@...@.@..@.@..
12
0 12 0
18 4 0
16 13 0
8 14 0
9 2 1
19 16 1
5 7 1
4 19 1
5 13 2
7 10 2
6 17 2
7 15 2

5 15 0
2 4 0
2 7 0
7 15 0
16 15 1
8 8 1
4 7 1
8 14 1
13 1 2
18 4 2
13 5 2
17 12 2
