width 20
height 20
@@@...@..@@@.@.@.@@@
@@@.@@.@..@....@.@.@
.........@@@.@......
@.@.@@.@@.@...@@.@.@
...@.@....@.@@..@...
@@@..@.@.@@@.@.@.@.@
@@.@....@.@......@..
....@@.@...@.@.@...@
.@.@@@...@.@@@@@@@..
@...@@.@..@@@......@
.@.@.@.@.@.@.@.@.@..
......@..@......@..@
.@.@.@.@...@.@.@@.@.
@@@..@...@..@.@.@...
@@@@...@..@......@.@
@@@@@@.@.@..@.@.@.@.
@@@@@@@@.@@.@@......
@@@@@@@@@@@@@..@.@.@
@@@@@@@@@@@@@@..@...
@@@@@@@@@@@@@@.@@@.@
12
6 1 0
12 5 0
14 7 0
1 9 0
17 18 1
1 7 1
11 16 1
7 13 1
5 6 2
7 4 2
15 14 2
18 19 2

12 1 0
15 2 0
0 12 0
8 7 0
0 10 1
7 13 1
14 1 1
6 14 1
14 0 2
8 4 2
12 6 2
16 14 2
