width 20
height 20
@.........@..@@@.@..
@.@.@@.@.@.@..@....@
...@...@.@.@.@.@.@.@
@.@.@.@@@@........@@
....@.@@..@@@.@.@..@
@.@..@..@..@.@@@..@.
.@@.@.@...@...@.@...
........@@.@.@....@.
.@@@@@@........@@.@@
@@.@@@@@.@@@@.@@@@..
@...@@..@@@...@@@.@.
.@.@.@.@.@.@.@@.....
...........@.@..@.@.
@@.@.@.@.@...@@.@@@.
@@@.@.@..@.@..@...@.
@@..@.@@@.@..@@@.@..
...@@.......@.@...@.
.@....@.@.@.@..@.@.@
..@.@.@@@.@@@@......
@..@..@@@......@@.@.
12
5 0 0
0 8 0
9 5 0
2 13 0
11 16 1
9 6 1
5 2 1
0 4 1
13 6 2
12 19 2
7 0 2
9 19 2

9 4 0
6 5 0
17 5 0
16 14 0
3 0 1
17 16 1
4 5 1
0 7 1
8 11 2
12 7 2
16 3 2
5 4 2
