width 20
height 20
@@.@.@.@.@.@@@@.....
@........@..@...@.@.
..@@.@.@...@.@@..@@@
@.@...@..@......@@.@
...@.@..@@.@.@.@@...
@.@.@.@...@@@....@.@
.......@.@@@.@.@....
@.@.@.@.@@@...@@@@@.
...@.......@@..@.@.@
@@..@.@.@.@..@......
.@.@.@...@..@.@.@.@.
...@..@.@.@....@@@..
@.@@@.......@@@@@.@.
@@@@@.@@.@.@@@.@....
.@....@..@.@@....@@.
...@.@..@.@.@.@.@..@
@@..@@.@@......@..@.
..@.@.@.@.@@.@@.@...
@.@.......@@......@.
....@.@@@@@@.@.@@.@@
12
16 9 0
10 13 0
1 15 0
8 8 0
18 8 1
4 11 1
2 16 1
18 3 1
8 0 2
6 8 2
2 10 2
9 15 2

11 15 0
0 6 0
15 10 0
12 6 0
15 15 1
19 10 1
12 11 1
12 3 1
9 17 2
1 1 2
14 8 2
16 13 2
