width 20
height 20
@@.@@@@@@@.@@@@@@.@.
@...@@@@@...@@@@....
.@@.@.@@.@.@@.@.@.@.
..................@.
.@@@@@@@.@.@.@@@.@..
.@.@..@.@@..@.....@.
...@@.@..@.@@@.@.@.@
.@..@..@..@.@.@@....
.@.@..@.@.@....@@.@.
@....@@.....@.@.@@.@
@@.@.@.@.@.@@......@
@@@.......@@@.@.@@..
@.@@.@.@@@@@.@@.@..@
@.@@@@@@.@@@...@.@..
@..@@@@...@@.@.....@
..@.@@.@.@..@..@.@.@
@.........@...@...@.
@@@.@.@.@...@..@.@..
@@@@...@@@.@.@..@@.@
@@@@@.@.......@.....
12
8 6 0
12 14 0
1 3 0
7 5 0
19 4 1
13 16 1
4 18 1
5 11 1
5 2 2
19 17 2
18 11 2
13 3 2

7 16 0
13 17 0
8 11 0
7 5 0
16 15 1
11 1 1
7 6 1
19 5 1
1 16 2
19 8 2
15 9 2
19 4 2
