width 20
height 20
@@@.........@@@@@...
@@..@@@.@.@..@@@.@.@
@.@.@...@@@.@.@@....
....@.@@@@.....@.@.@
.@.@.@.@@.@.@@.@.@@@
..@@.........@@@...@
.@...@.@.@@@@@@@.@..
..@.@.@.@@.@..@..@.@
.@.@@.@.@...@...@@.@
...@.....@.@..@@@@@@
.@.@.@.@....@.@@@@.@
@...@..@.@@.....@...
.@.@.@@.@@.@.@@..@.@
............@@.@....
.@.@.@.@.@.@.@.@.@.@
..@.@..@@..@......@@
@...@@.@.@.@.@.@.@.@
..@.@.@@.@.@..@@....
@.@@@.@@.....@@@@.@.
@.......@.@@@@@@@.@@
12
0 4 0
8 9 0
0 6 0
8 0 0
10 13 1
3 3 1
2 3 1
17 2 1
5 8 2
1 15 2
14 16 2
18 11 2

16 17 0
5 13 0
19 2 0
5 11 0
4 5 1
5 18 1
19 17 1
6 19 1
6 14 2
18 8 2
8 13 2
16 14 2
