width 20
height 20
.@@.....@@..@.@.@@@@
....@.@.@..@@...@.@@
.@@@.@.@.@.@.@@.@..@
..................@@
@@.@.@.@@.@.@.@.@.@@
....@@@....@.@...@..
@@.@@@@@@.@@..@@...@
@.@.@.@.@..@@..@.@..
..........@...@@@.@.
@@@.@.@.@.@@@..@@...
..@..@.@..@...@...@.
@.@.@@.@@@.@.@.@@..@
................@.@.
@.@.@.@.@.@@@.@@....
@@@@@@@.@@....@@@.@.
@@@@@.@@.@@.@.@...@.
@@@@.........@@.@@..
@@@..@@.@.@.@@@...@.
@@@@...@..@@.@..@.@.
@@@@@@.@@....@.@...@
12
13 4 0
9 4 0
2 4 0
8 2 0
5 1 1
6 11 1
19 8 1
15 15 1
7 16 2
9 9 2
0 10 2
13 9 2

14 3 0
6 18 0
17 14 0
4 12 0
12 10 1
4 0 1
19 8 1
16 15 1
8 16 2
14 1 2
17 17 2
15 2 2
