width 20
height 20
......@........@.@@@
.@.@@.@@@.@.@.@@..@.
..@@...@...@..@..@@.
.@.@@.@.@.@.@@@@..@.
....@............@..
.@.@@@.@.@.@.@.@...@
.@@.@@@@.@.@.@.@@.@@
@....@..@.@.@.@.@.@@
..@.@.@............@
@.@.....@@@@@.@@@.@@
@.@@@@@.@.@...@@@@@@
@@.@.@....@.@.@@@@@@
@..@.@.@@.@@@@..@@@@
..@....@....@..@@@@@
@..@.@@.@.@@.@..@@@@
..@.@@.....@...@@@@@
@.@.@.@.@.@..@@@@@@@
@........@.@.@.@.@@@
..@.@.@@..........@@
@..@..@..@.@.@@@@...
12
1 14 0
3 6 0
14 12 0
8 13 0
9 1 1
6 12 1
3 7 1
1 10 1
2 4 2
6 7 2
7 15 2
1 19 2

1 12 0
3 18 0
0 5 0
8 2 0
11 4 1
16 5 1
13 7 1
1 19 1
9 10 2
1 0 2
0 1 2
7 10 2
