width 20
height 20
@@@@@@@@@@@@@@@@@@@@
@@@@@@@@@@@@@@@@@@@@
@@@@@@@@@@@@@@@@@@@@
@@@@@@@@@@@@@@@@@@@@
@@@@@@@@@@@.@@@@@@@@
.@@@@@@@@@...@@@@@@@
...@@@@@@@@.@@@@@@@@
.@.@@@@@@....@@@@@@@
.@.@@..@..@@..@@@@@@
.@@.@.@@@..@.@.@@@@@
.......@..@.@@...@@@
@.@.@.@.@...@..@.@@@
...@......@...@.@@@@
@.@.@@@.@@..@....@@@
..@.@@@@...@..@.@@@@
@....@@@@.@.@.@@@@@@
@@.@..@@.@@....@@@@@
@@..@@......@@.@@@@@
@.@...@.@@@..@@@@@@@
....@..@@@@@....@@@@
12
15 13 0
1 14 0
9 8 0
7 12 0
1 12 1
5 19 1
14 11 1
12 5 1
2 6 2
0 7 2
14 17 2
6 8 2

1 14 0
11 16 0
13 11 0
1 10 0
12 18 1
13 19 1
5 10 1
1 12 1
7 17 2
11 15 2
11 4 2
15 19 2
