width 20
height 20
@...@@.......@...@@@
.@.@...@@.@@...@@..@
....@@.@.@@@.@.@.@..
@@.@@.....@@@......@
.@....@.@@..@@.@.@@@
.@.@.@@@@@@..@@@@.@@
....@@@@@@..@.@.@..@
.@.@@@@@@.@.......@.
@..@@@..@..@@.@.@@..
@@.@@@.@.@....@.@.@.
@@.@@....@.@.@......
@..@.@.@....@@@.@.@.
.@......@.@...@@.@..
.@@.@.@@..@.@@@..@@.
..@@@@..@@.@@.@.@.@.
@.@.@@@.......@.....
.....@.@.@.@@.@.@@@@
.@.@......@@.......@
..@@@.@.@.@.@.@.@.@@
.@@@@.@.@.@....@@...
12
10 10 0
11 0 0
19 7 0
18 8 0
15 9 1
5 17 1
2 2 1
7 12 1
4 12 2
19 15 2
15 6 2
7 19 2

19 15 0
17 10 0
4 1 0
15 10 0
1 8 1
19 13 1
3 12 1
0 7 1
6 14 2
14 10 2
12 9 2
17 19 2
