width 20
height 20
@@.@.@...@@@@@@@@@@@
@@....@@..@@@@@@@@@@
.@.@.@.@.@@@@@@@@@@@
....@.....@@@@@@@@.@
.@.@.@.@.@@.@@@@@@.@
.@.....@.@..@.@@@...
..@.@@..@@@....@.@.@
.@@@.@.@.@@.@@@.....
@@@@.@....@..@.@.@.@
@@@@...@.@.@.....@@@
@@@.@.@@....@.@@@@@@
@.....@@@.@....@@@@@
..@.@.@@@@..@.@@@@@@
@@.@.@.@@.@..@@@.@@@
@...........@@@....@
.@.@@@.@.@@.@@.@.@@@
......@.@..........@
.@@.@.@...@.@.@.@.@.
.@.@.@.@@.@.@@..@@@.
.......@@@@@@@@.....
12
15 17 0
11 11 0
7 0 0
11 4 0
8 4 1
9 3 1
13 9 1
10 14 1
5 10 2
14 16 2
13 16 2
0 12 2

6 14 0
3 10 0
8 1 0
5 19 0
1 16 1
8 4 1
2 3 1
17 5 1
6 18 2
12 8 2
0 7 2
18 19 2
