width 20
height 20
@@@@@@@@@@@.@@.@@...
@@@@@@@@@@...@.@.@.@
@@@@@@@@@.@.@.......
@@@@@@@@@.....@.@.@.
@@@@@@@@..@@.@...@..
@@@@@...@@..@@@.@.@.
@@@@@.@@.@.@@@....@@
@@@@........@@@.@...
@@...@.@.@.@.@.@..@@
...@.@..@@.......@@@
@@..@.@@..@@.@.@.@@@
@..@...@.@@..@@.@@@@
.@...@@@.@.@@.@...@@
.@.@...........@.@@@
..@@.@.@.@.@.@....@@
@.@.@@@.@@@@@@.@.@@@
........@@.@...@@@@@
@.@.@.@......@.@@@@@
...@.@@@@.@@..@@@@@@
.@......@...@@@@@@@@
12
18 0 0
12 17 0
4 9 0
18 1 0
17 7 1
15 3 1
19 4 1
14 6 1
19 2 2
10 9 2
16 15 2
12 11 2

10 3 0
3 8 0
16 6 0
9 13 0
7 19 1
15 11 1
10 7 1
1 17 1
6 11 2
1 16 2
15 2 2
9 10 2
