width 20
height 20
@@@@@@@@.@@@@@@@@@@.
@@@.@@.@.@@@@@@@@@..
@@.....@..@...@.@.@.
@@@.@@...@..@@......
@@@@...@@.@.@.@.@.@.
@@@@.@...........@..
@@..@.@.@.@@@.@.@..@
@.@......@@@@@...@@@
....@.@.@@@@@..@.@.@
.@@..@..@@@@@@.@@...
@.@.@.@@.@@@..@..@.@
......@......@.@...@
@@.@@...@@@@.....@..
..@.@@@.@.@.@.@@..@.
@............@...@@.
@@.@.@.@.@.@.@.@.@..
@..@@@@@@...@.@.@.@.
@@..@@@@@@.@........
@..@@@@@@@@@@.@.@.@.
@@.@@@@@@@@@...@@@..
12
13 5 0
8 14 0
8 2 0
16 7 0
12 11 1
17 6 1
2 15 1
6 7 1
5 2 2
3 9 2
13 19 2
15 6 2

13 13 0
3 13 0
17 16 0
14 19 0
9 4 1
9 5 1
18 6 1
3 17 1
15 17 2
10 15 2
19 4 2
7 11 2
