width 20
height 20
@@@@@..@@@@.@@@@@@@@
@@@@..@.......@@@@@@
@@@.@.@.@.@.@..@.@.@
@@......@@.@.@@@.@..
.@@.@.@@...........@
..@..@@@@.@@.@.@.@..
@.@.@..@@@@@@.@.@..@
......@.@.@.......@@
@.@.@.@...@.@.@.@.@@
@@@@....@....@@..@@@
@@@..@@..@@.@@@.@@@@
@@@@...@..@@....@@@@
@@@@@.@@.@@@@.@@.@@@
@@@@@.@.@@.@......@@
@@@@@@......@.@@.@.@
@@@@@@@.@.@..@@.....
@@@@@@..@.@@.@.@@.@.
@@@@@@@..@@@......@@
@@@@@@..@.@.@.@.@...
@@@@@@@......@...@.@
12
4 3 0
9 11 0
18 14 0
11 2 0
8 11 1
16 3 1
15 11 1
18 18 1
16 17 2
4 10 2
11 7 2
14 19 2

11 9 0
3 3 0
19 16 0
5 3 0
17 18 1
13 7 1
11 0 1
18 4 1
13 12 2
7 18 2
9 18 2
17 16 2
