width 20
height 20
@..@.@@....@.@...@..
.@.@....@.@@.@@.@..@
.....@.@.........@.@
.@@@.@@.@.@.@@.@....
...@@....@.@...@@.@.
.@@.@.@.@....@...@..
.....@...@.@.@@.@@@@
@.@.@@.@...@@.@.@@@@
.@@..@@.@.@@@.@@.@@@
...@@.....@@@.....@@
.@.@..@.@@@@@@.@@@@@
..@.@..@@@@.......@.
@.....@@@...@@.@.@..
..@.@..@.@@@.@..@.@.
@..@.@.......@.@....
..@@..@.@@.@.....@@@
.@...@.@@..@.@.@....
@@.@......@.@.@..@@.
@@@..@.@.@......@.@.
@@@@..@@@@@.@.@@....
12
2 10 0
15 9 0
3 12 0
12 4 0
5 1 1
16 9 1
14 2 1
13 11 1
8 4 2
0 10 2
9 8 2
14 14 2

4 0 0
13 4 0
4 17 0
12 4 0
15 5 1
2 9 1
1 7 1
3 5 1
19 0 2
4 3 2
8 17 2
14 2 2
