width 20
height 20
@@@@@@.@@.@.@.@.@@@.
@@@@@.......@.......
@@@@@@.@@.@@@@@.@.@.
@@@@@@.@.@..@....@.@
@@@@@....@.@.@.@@...
@@@@@@.@..........@@
@.@@@@@@@@.@.@.@@...
@.@@@@@@@@..@...@@.@
...@@@@@@..@.@@@..@@
@.@.@@.@.@...@.@.@.@
...........@........
.@.@.@.@.@@..@.@.@.@
@@@@@@..@@@@..@..@@.
@@@@@..@@@@@@.@@....
@@@@@@.@@@@@@@@@@.@.
@@@@@@@@@@@@@@@@@@..
@@@@@@@@@@@@@@@@@@@.
@@@@@@@@@@@@@@@@@@@.
@@@@@@@@@@@@@@@@@@@@
@@@@@@@@@@@@@@@@@@@@
12
10 6 0
10 10 0
6 0 0
19 1 0
18 7 1
3 9 1
8 3 1
18 6 1
11 7 2
7 12 2
8 4 2
7 4 2

3 10 0
9 1 0
13 5 0
19 17 0
19 6 1
12 6 1
7 4 1
11 3 1
9 8 2
4 10 2
1 10 2
10 5 2
