width 20
height 20
@@@..@..@.@@..@.....
.@..@@@.@...@.@@@.@.
..@.......@....@..@.
@.@.@.@.@@.@.@...@..
....@..@......@.@.@.
.@@.@@@.@@.@.@.@@...
...@....@@..@..@..@@
@.@@@.@.@.@.@.@.@..@
..@@@@.....@......@.
@.@.@.@.@.@.@.@.@@..
.........@.....@..@.
@.@.@.@.@@.@@@...@@.
@@@@..@.@.@.@..@....
@.@.@..@.....@@.@@.@
......@@@.@@........
@.@.@.@@....@@.@.@.@
@..@..@.@.@@..@@@@@@
@.@.@@.......@@@@@@@
@.....@.@.@@@.@.@@@@
@@.@.@@@.........@@@
12
16 15 0
9 4 0
18 13 0
12 5 0
0 14 1
5 14 1
10 11 1
6 2 1
2 6 2
11 6 2
16 6 2
12 14 2

17 5 0
15 14 0
13 0 0
17 1 0
11 15 1
17 0 1
13 9 1
3 2 1
18 7 2
1 7 2
1 8 2
19 2 2
