width 20
height 20
..@@.@@.@@.@.@......
.@@..........@@@.@.@
.@.@.@.@.@.@.@.@.@..
....@@@@.@@.....@..@
@@.@.@@@.@.@.@.@@@.@
@@....@.....@...@...
@@.@.@@@.@@..@.@.@.@
@.@...@.@@@.@.......
@...@@.......@@.@.@.
.@.@@@@.@.@.@@@@@@..
.......@...@@@@@@@@.
.@@.@.@@@.@@@@@@@@@.
.@.@.@.@....@@@@@@@.
........@.@..@@@@@@@
.@.@.@.@.@..@@@@@@@@
..@@@......@@@@@@@@@
.@@@@@@.@.@@@@@@@@@@
.@@@@.@..@@@@@@@@@@@
..@@....@@@@@@@@@@@@
.@@@@.@.@@@@@@@@@@@@
12
9 16 0
18 9 0
3 8 0
2 2 0
15 0 1
6 10 1
7 17 1
1 7 1
19 7 2
10 4 2
15 7 2
13 3 2

2 3 0
9 1 0
10 12 0
2 2 0
9 15 1
6 15 1
1 8 1
0 9 1
15 5 2
19 5 2
11 12 2
11 13 2
