width 20
height 20
@@@@@@@@@@@.@.@@.@.@
@@@@@@@@............
@@@@@.@.@.@.@.@.@.@@
@.@........@@@@@...@
....@@.@@@..@@@@@.@.
@.@...@.@.@@@..@@@..
@@..@.........@.@.@.
@@@..@@.@.@.@.......
@...@..@.@@@..@.@.@@
..@.@@....@.@.@@....
@..@.@.@.@...@...@.@
.@......@@.@..@.@...
.@.@.@.@.@@.@.@.@.@.
..@...@.......@..@..
.@.@.@.@.@.@@@..@.@.
.......@..@@@.@....@
@.@@.@...@.@@.@@.@..
@@.@@@.@.@.....@@..@
@.......@@@.@@...@..
@@.@.@.@@@@@@@.@...@
12
8 6 0
2 12 0
10 4 0
15 14 0
3 5 1
14 14 1
0 12 1
8 17 1
9 15 2
11 9 2
8 10 2
7 3 2

11 10 0
1 10 0
13 7 0
18 19 0
7 5 1
2 6 1
9 3 1
17 7 1
10 11 2
17 14 2
4 19 2
16 3 2
