width 20
height 20
...@@@@@@@@@@@@@@@..
.@@.@@.@@..@@@@@@.@.
..@..@.@..@@@@@.@...
.@..@...@..@@@....@@
...@.@.@..@@@.@.@@..
@@.......@........@.
@@@.@@.@..@@@@@.@...
@@@@.@@.@...@..@@.@.
@@@.......@...@..@..
@@..@.@.@@.@@@.@.@@.
@@.@.@.@............
@........@.@.@.@.@@.
@@.@@@@@..@...@@@..@
@@@@@@@..@.@.@....@@
@@@@@@@@@....@@.@..@
@@@@@@..@@.@.@.@.@..
@@@@@..@....@....@.@
@@@@@.@.@.@@.@.@....
@@@@......@.....@@.@
@@@@@.@@@...@@.@....
12
12 15 0
10 15 0
19 2 0
7 15 0
12 13 1
19 4 1
18 12 1
14 17 1
8 8 2
13 12 2
11 7 2
7 5 2

18 14 0
9 16 0
9 14 0
16 17 0
10 19 1
0 4 1
14 16 1
3 1 1
16 9 2
13 12 2
9 18 2
17 2 2
