width 20
height 20
...@..@....@@..@....
@@...@@@.@....@.@@@.
...@@.@@..@.@....@@.
@@.@@..@.@@@..@.@...
...@..@.@.@.@.@.@@@.
@.@..@@........@....
....@...@.@.@@.@.@.@
@.@..@.@..@.@.@.@...
@..@.@.@@..@....@@.@
..@...@@..@.@.@....@
@@.@.@.@.@..@@.@.@..
...........@.@.@@.@.
@.@@.@@@.@@.........
....@....@@@.@.@@.@.
@.@@@@.@..@..@@@@@.@
..@@@@@.@..@...@@@.@
@.@@@....@@.@.@@@...
..@@.@.@.......@.@.@
@.......@.@.@.@.....
@@.@.@.@@.@@....@.@.
12
15 9 0
1 12 0
1 14 0
12 8 0
13 1 1
5 4 1
12 15 1
14 8 1
0 2 2
3 6 2
4 19 2
13 7 2

14 10 0
0 15 0
1 13 0
9 19 0
18 0 1
16 6 1
9 0 1
12 15 1
8 3 2
16 12 2
7 18 2
13 7 2
