width 20
height 20
@@@.....@...........
@@..@.@...@.@@.@.@.@
@@.@@@..@.@...@@@@@@
@@.@..@.@@@@.@.@.@.@
..@@@.@.@.@.@.......
@..@..........@.@@@.
..@.@.@.@.@.@..@@...
@...@@...@@@@@..@@.@
@.@...@.@@@.@..@@@@@
@.@.@@.......@@.@@.@
@@@..@@.@.@.@@......
@...@..@...@.@.@.@.@
.@@..@..@@....@@@@..
....@.@.@@@@.@@@@..@
.@.@.........@.@.@.@
..@.@.@@.@@@........
.@......@@@@.@.@.@.@
..@.@.@.@@@@@@@@@...
@.@..@@@@@@@@@@@@@.@
....@@@@@@@@@@@@@@@@
12
11 6 0
17 6 0
3 12 0
12 5 0
12 11 1
14 15 1
7 7 1
16 16 1
18 0 2
8 14 2
17 4 2
12 15 2

7 7 0
6 2 0
7 16 0
1 17 0
3 0 1
16 14 1
3 10 1
2 7 1
12 2 2
11 0 2
18 3 2
17 15 2
