width 20
height 20
..@@@@@....@@@@@@@@@
.@.@...@@.@.@@@@@@@@
.....@......@@@@@@@@
@.@.@..@.@@@...@..@@
...@.@.@.....@@..@.@
@.@@....@.@.@..@....
@.@..@.@...@..@..@.@
@@.@.@..@.@@.@.@.@@.
.....@@@.@@@........
.@.@..@......@.@@@@@
@@@@.@.@.@@.@@@..@..
@@.........@@.@.@.@.
@@@@.@.@.@@@......@.
@@@@@@.@@.@.@.@.@...
@@@@@..........@..@.
@@@@@@@.@.@.@.@@@.@.
@@@@@@@@@@...@@...@.
@@@@@@@@@@@.@...@..@
@@@@@@@@@@@@.@@..@..
@@@@@@@@@@@@....@..@
12
13 19 0
16 5 0
17 14 0
17 17 0
6 4 1
15 8 1
6 12 1
6 13 1
11 1 2
19 12 2
9 13 2
0 1 2

17 15 0
4 7 0
2 8 0
12 3 0
6 12 1
6 3 1
12 19 1
4 8 1
5 11 2
19 11 2
18 5 2
17 13 2
