width 20
height 20
...@@@@........@@.@@
.@.@@.@@.@.@.@..@..@
@........@..@.@...@.
@@.@.@.@..@...@@@...
@@.@..@..@@@@.@@@.@.
...@.@@@@.@.@@.@.@@.
@.@@@.@.@...........
...@......@.@@.@.@.@
@.@@@.@.@..@@@@...@@
....@.@..@@@....@.@@
@.@.@@..@@.@.@.@..@@
.@....@.....@.@.@@.@
..@.@@@@.@@.........
@....@@@@..@.@.@.@.@
..@.@@@@@@.@@.@@@...
@..@@@@@......@@@@@.
@.@.@.@.@@.@.@@@@@..
............@@@.@.@.
@.@.@@.@@.@@@.......
@@...@..@....@.@@.@.
12
17 6 0
4 17 0
18 12 0
12 13 0
4 11 1
7 6 1
11 3 1
18 14 1
1 15 2
15 1 2
16 6 2
3 13 2

15 1 0
16 6 0
16 2 0
8 0 0
16 5 1
14 19 1
10 15 1
3 11 1
17 6 2
6 10 2
5 9 2
19 15 2
