width 20
height 20
@.@@@@......@.@.@.@.
...@.@@.@@@.@.......
@.@..@....@@@@@.@.@@
....@.@.@.@.@....@@@
@.@....@.....@@.@@@@
...@@.@@.@.@.@@..@@@
@.@@......@@....@..@
@...@@.@@..@@.@...@@
@.@.@.@@@@@@@@@.@.@@
.@......@@@.@..@...@
...@.@.@@@....@.@.@@
@.@.@@..@@@.@.....@@
@.@..@.@.@...@@.@.@.
...@......@.@....@..
@.@..@.@@@...@.@@.@.
...@..@@@@@.@.......
@.@..@@@@@@..@.@@@@.
...@..@@@@@.@.@@....
@.@@.@@@@@@@@.@.@@.@
@@....@@@@@@........
12
15 2 0
18 15 0
15 7 0
14 1 0
1 0 1
17 14 1
3 8 1
6 6 1
9 13 2
8 4 2
3 7 2
7 11 2

12 6 0
15 19 0
3 19 0
4 2 0
6 13 1
17 9 1
16 5 1
10 0 1
1 1 2
4 14 2
19 14 2
14 6 2
