width 20
height 20
@@..@@@.@.@@@@@@@@@@
@@@..@@...@@@@@@@@.@
.@@.@.@.@.@@@@@@@@.@
.........@...@@.@...
.@@.@@.@.@@.@@....@@
@@@@...@@@.....@@.@@
@@@.@.@.@.@.@.@.@@.@
@...........@@......
.@.@.@.@@@@.@..@@.@@
....@@....@@.@.@.@.@
@@.@@..@.@.@.....@..
..@@..@.....@.@@...@
@....@.@.@@.@@@.@@..
@@.@....@@......@..@
@.@@@.@@..@.@.@.@@.@
...@...@.@@@@@......
@.@@@.@...@.@.@.@.@.
.......@.@.......@..
@.@.@.@....@@.@.@@@.
..@..@@@.@@....@@@..
12
14 17 0
2 13 0
8 12 0
14 13 0
4 7 1
8 14 1
3 18 1
0 15 1
3 6 2
15 12 2
13 14 2
16 9 2

1 15 0
10 18 0
5 5 0
14 8 0
13 10 1
13 16 1
6 17 1
19 7 1
8 16 2
18 7 2
14 15 2
11 11 2
