width 20
height 20
@@@@@..@.@@@@@@..@..
@@@@@@....@@@@..@.@.
@@@@@..@@...@.@.....
@@@@@@.@..@....@.@@.
@@@@..@@@@..@.@.@.@.
.@@.@.@....@........
.......@.@..@.@.@@@@
@@@.@.@.@..@.@..@...
@@@..@...@....@..@@.
@@@.@@.@@.@@@@..@.@.
@.............@.....
@@.@.@.@@@.@.@..@.@.
@@@..@.@@@@...@..@..
@@@@.@@@@@.@.@.@@.@.
@@@..@.@@...........
@@@@....@@.@.@.@.@.@
@@@@.@.@@...@@@@@@@@
@@@..@...@.@...@@@@@
@@@@..@.@.@.@.@.@@@@
@@@@@@...........@@@
12
13 5 0
12 3 0
19 8 0
6 10 0
12 12 1
19 0 1
6 19 1
6 6 1
5 18 2
2 6 2
7 10 2
11 6 2

13 5 0
17 14 0
13 19 0
12 3 0
15 8 1
19 2 1
5 10 1
15 6 1
19 10 2
13 12 2
15 2 2
12 10 2
