width 20
height 20
..@.@.........@@@@@@
.@....@.@.@@@..@@@@@
.@.@@.@@..@.@.@@@@@@
.@...@@@@@.....@@@@.
...@@..@..@.@.@.@...
.@....@@@..@......@.
.@.@.@@@..@@.@.@@@..
@.@.@.@.@.@.@.@.@.@.
@...................
@.@.@.@@.@@.@.@.@.@.
...@..@.@@@@..@..@..
@.@.@.@.@.@@@.@@..@.
.....@....@@@@.@.@@.
@@.@.@@.@..@@......@
...@.@@@@.@@@@.@.@..
@.@@@..@@.@@@@..@..@
@..@..@.@..@..@@.@..
..@.@.....@.@......@
@...@@.@@.@...@@.@..
..@@...@....@.@@@..@
12
18 8 0
2 1 0
5 2 0
3 18 0
4 6 1
18 4 1
8 12 1
7 7 1
14 5 2
17 7 2
16 12 2
13 5 2

11 2 0
0 1 0
4 13 0
5 4 0
7 0 1
7 1 1
3 0 1
7 13 1
3 8 2
3 7 2
16 12 2
2 4 2
