width 20
height 20
@@@@@.@@@.@.@..@@@@@
@@@.@..@......@@@@@@
@@....@.@.@.@@@@@@@@
@@@.@....@........@@
@@.@..@.@@@.@.@.@...
@..@@..@@@.@...@@.@@
@@.@.@..@..@@.@..@.@
.@.....@@@.@@...@@..
...@.@..@....@.@@..@
@.@...@@.@.@@...@@..
@@@@@.@@.....@@....@
......@..@.@...@.@.@
.@.@.@.@.@..@@..@...
..@.......@@.@@@.@.@
.@.@.@.@.@.@........
@....@@@@@.@.@.@.@.@
@@.@@@@@@.....@...@@
@...@@.@.@.@.@@@.@@@
@.@.........@@@@...@
...@.@.@.@.@@@@..@.@
12
11 1 0
4 8 0
2 12 0
9 6 0
14 3 1
7 13 1
10 17 1
12 5 1
10 18 2
12 17 2
9 13 2
3 17 2

11 1 0
4 8 0
17 14 0
10 11 0
8 18 1
10 12 1
2 17 1
13 5 1
18 13 2
14 11 2
13 7 2
0 14 2
