width 20
height 20
@@@@@@..@.@@..@@@.@@
@@@@@..@..@.@..@..@@
@@@@.@.@.@@.@.@.@..@
@@@.........@.....@@
@@..@.@@.@.@..@.@@@@
@.@.@@.@@....@.@@@@@
....@...@@.@....@@@@
.@.@..@..@.@.@.@@@@@
..@..@.@@.@.@@..@@@@
.@@@...........@@@@.
..@@@.@@@.@.@.@@.@..
.@.@.@.@@@.@.@.@..@.
................@...
@@.@@.@.@.@.@.@...@.
....@..@@@..@@..@.@.
.@.@..@...@@.@.@..@@
@..@@...@@....@@@...
@@@@@@.@...@.@.@@.@.
@@@@@.@.@.@@......@.
@@@@.......@.@.@.@..
12
15 18 0
6 6 0
2 15 0
13 9 0
10 11 1
5 12 1
4 12 1
4 15 1
8 9 2
8 15 2
12 0 2
12 17 2

6 6 0
2 4 0
0 14 0
16 10 0
10 6 1
3 3 1
15 2 1
19 14 1
5 7 2
5 3 2
14 14 2
6 8 2
