width 20
height 20
@..@.@.@@....@...@..
@.@......@.@@.@.@.@.
....@.@@@...........
@@.@.@..@@@@.@.@@.@.
......@.@...@..@...@
.@@.@...@@.@@@@.@@..
@@@.@.@..@.@@.@.@.@.
@@.@...@..........@.
....@.@@@@.@.@.@@...
.@@....@..@...@@@.@.
@.@.@.@.@..@@.@..@@.
@....@@..@...@..@...
@.@@.@@@...@@.@...@.
@.@.@.@@.@@.@..@@@..
..............@@@@@.
.@@.@.@@.@@.@.@@@...
@@@.@@.@@..@@@.@.@@.
.@...@....@.@....@..
..@@...@.@....@.@.@.
@....@.@...@.@....@@
12
3 14 0
0 17 0
17 7 0
3 10 0
10 0 1
5 10 1
14 4 1
2 8 1
13 12 2
1 18 2
7 10 2
2 7 2

5 18 0
0 8 0
3 6 0
1 14 0
9 19 1
14 3 1
2 17 1
2 19 1
12 8 2
13 18 2
10 11 2
1 2 2
