width 20
height 20
@.@@@@@.@.@....@@.@@
@..@@@@.@...@@......
@.@.@@....@...@.@.@.
......@@@..@.@...@..
@@.@@.@...@@@@.@@.@.
..@...@.@@@@@@.@...@
@..@.@@@.@.@@....@..
..@..@...@.@.@@.@.@.
@...@@@@.@.....@@...
.@@.@.@....@.@@...@.
........@.@...@.@..@
@.@.@@.@@@@@.@.@@.@.
@..@..@@..@..@....@.
.@..@.@.@...@..@@.@.
...@......@@.@.@....
.@..@.@.@@.....@@@@.
..@..@@....@@.@.....
.@@.@@@@.@@.@@.@.@.@
@@@@@@@@@.........@@
@@@@@@@@@@.@.@.@@...
12
15 12 0
13 13 0
7 4 0
19 9 0
10 1 1
19 19 1
10 9 1
11 0 1
19 6 2
2 10 2
1 2 2
2 12 2

0 10 0
1 16 0
9 4 0
7 9 0
5 10 1
1 11 1
9 9 1
8 12 1
17 12 2
7 4 2
11 17 2
17 9 2
