width 20
height 20
@@@......@.....@..@@
@@.@.@@@.@.@.@...@.@
@...@@.@....@@@.@...
..@......@.@....@.@@
@@..@.@.@@@.@.@....@
@@@..@...@..@@@.@@..
@@..@.@.@..@.@.@..@@
@.@...@@.@......@.@@
....@......@@.@.@..@
@.@..@.@.@...@@...@@
@.@.@@@.@..@@@@.@..@
.@..@@@..@...@@@@@..
...@@@@.@@.@@.@.@..@
@@..@@....@.@....@.@
@.@..@.@@.....@@....
@.@.@.@...@@@.@@@@.@
..@....@.@.@.@.@....
@.@.@.@.........@@.@
.....@@@.@.@.@.@....
.@@.@@@@..@...@..@.@
12
14 0 0
9 17 0
4 16 0
7 12 0
3 18 1
15 13 1
17 18 1
8 18 1
9 2 2
3 6 2
6 8 2
8 11 2

18 16 0
15 12 0
8 13 0
11 7 0
0 11 1
5 7 1
15 1 1
3 6 1
8 9 2
12 19 2
10 8 2
14 7 2
