width 20
height 20
.@..@...@..@..@@@...
.@@.@@.@.@...@.@@.@@
.....@...@.@.......@
.@.@...@...@@@.@@.@.
@@@..@@@@@.@@.@@....
@@@@...@@.@.@.@.@.@.
@.@.@@...........@..
.....@@.@.@.@@.@.@@.
@.@.@@.@.@....@.@.@.
@.@@@.....@.@@......
...@@@.@.@@...@@@.@.
@.@@@@@...@.@...@@@@
@.@@@..@.@@@.@.@....
@.@@.@....@......@.@
...@...@.@@@.@@.@..@
@.@..@.@..@....@..@@
@...@.@.@@.@@@@.@.@@
..@................@
.@..@.@.@.@@.@.@.@..
@@@..@@..@...@.@@..@
12
5 0 0
13 15 0
6 15 0
10 16 0
19 18 1
4 14 1
12 8 1
16 9 1
19 3 2
3 6 2
11 9 2
14 12 2

17 2 0
1 6 0
12 10 0
16 17 0
8 15 1
15 8 1
6 15 1
12 6 1
14 7 2
16 9 2
11 5 2
3 16 2
