width 20
height 20
@@@@@@@@.@.@.@....@@
@@@@@@@........@.@..
@@@@@@@@.@.@@.@@@..@
@@@@@@@...@..@@@..@.
@@@@.@.@@.@.@.@..@..
@@.....@......@.@.@.
@@.@.@..@@@.@.......
@@@.@.@.@@@@..@.@.@.
@@@......@@..@...@@@
@@..@.@.@@.@..@.@@@.
@.@..@@@@....@@@..@.
..@.@.@.@@@.@.@@@.@.
@...........@..@....
..@.@.@@.@@...@.@.@.
@..@@@.@@.@.@@..@@..
..@@@@..@..@@.@..@@.
@...@@.@.@....@@..@.
@@.@.......@.@@..@..
@@...@.@.@@..@.@.@.@
@@.@.@@...@@........
12
10 9 0
9 3 0
15 19 0
2 14 0
3 9 1
2 9 1
16 18 1
13 12 1
11 18 2
6 15 2
9 15 2
10 12 2

17 12 0
19 10 0
10 2 0
4 5 0
2 14 1
11 1 1
1 15 1
13 19 1
1 10 2
17 3 2
19 17 2
8 5 2
