width 20
height 20
@@@@@.............@.
@@@@@@.@.@@.@.@.@.@.
@@@@@@@@@.@@...@....
@@@@@@@@@.@.@@..@.@.
@@@@@@.........@.@..
@@@@@.@@.@@.@.@...@.
@@@@....@..@@@.@@...
@@@@@.@...@.@@...@@.
@@@@@@@@@......@.@..
@@@@@@@@@@@@@.@..@@.
@@@@@@@@@@@@@@..@.@.
@@@@@@@@@@@@@@@.....
@@@@@@@@@@@@@@@@.@@.
@@@@@@@@@@@@@@@....@
@@@@@@@@@@@@@@.@.@..
@@@@@@@@@@@@@...@.@.
@@@@@@@@@@@@@@@.@...
@@@@@@@@@@@@@@....@.
@@@@@@@@@@@@@@@@@..@
@@@@@@@@@@@@@@@@@.@@
12
16 8 0
18 4 0
19 11 0
16 14 0
13 4 1
14 8 1
19 8 1
18 18 1
11 5 2
18 11 2
19 16 2
14 2 2

6 0 0
19 4 0
8 5 0
9 4 0
16 9 1
12 8 1
14 7 1
15 9 1
7 4 2
11 3 2
19 0 2
11 0 2
