width 20
height 20
@@@@@..@@.@...@@....
@@@@@.@.@.@@.@.@.@@.
@@@@...............@
@@@@@.@.@.@.@.@.@.@@
@@@@@@@@.@.@@.@.@..@
@@@@@@@@...@.@.@@.@.
@@@@@@@..@..........
@.@.@..@..@.@.@.@.@.
@...@@...@...@@@...@
..@.@..@@@@.@@@.@.@.
.@.@.@..@@@..@......
.....@.@.@.@@.@@@.@@
.@.@.............@@.
..@.@.@@.@.@@.@@@@..
.@@..@@@..@@...@..@.
....@@@..@.@.@@.@...
@.@@.@.@@@........@@
.@.........@.@@.@..@
...@@.@@.@@@@@@@..@.
.@@...@..@@@@@@@@...
12
15 4 0
15 2 0
12 0 0
1 8 0
19 7 1
3 8 1
11 2 1
15 16 1
7 17 2
9 3 2
3 15 2
17 17 2

3 19 0
0 9 0
6 12 0
13 16 0
2 18 1
9 12 1
4 10 1
5 19 1
7 1 2
17 7 2
3 7 2
8 14 2
