width 20
height 20
..............@.@.@.
@@.@.@@.@.@@@.......
....@..@@@.@.@@@.@@.
.@.@..@.......@@@@@.
.@...@.@.@.@.@.@.@@.
..@@.....@@.......@@
.@@.@.@.@..@.@.@.@.@
@......@..@@@@@.....
..@.@.@..@.@.@.@.@@.
.@.@@@@.@@........@@
...@@@..@.@@.@.@.@..
@@@.@.@.......@@@@@.
........@.@.@..@@@..
@.@.@@.@...@@.@@@.@.
@@..@@@@@.@@.@@@@...
..@.@@.@.@...@@@..@.
@..........@@.@.@..@
.@.@@.@.@@.@......@.
.....@@@.@.@@.@.@...
.@@.@@@........@@.@.
12
10 4 0
7 12 0
12 5 0
13 13 0
5 0 1
14 6 1
0 6 1
3 14 1
7 19 2
3 16 2
17 5 2
14 19 2

12 15 0
10 16 0
0 2 0
0 18 0
19 12 1
9 6 1
12 9 1
15 17 1
8 7 2
5 0 2
16 4 2
8 18 2
