width 20
height 20
@@@@@@.@@.@.@@@.@@.@
@@@@@........@...@..
@@@@@.@.@.@.@@@.@..@
@@@@@..@.@.@.@@..@..
@@@@.@.........@...@
@@....@@@.@@.@@..@@.
@.@@.@.@.@.@.@.@..@.
.................@..
@.@.@.@.@.@.@.@@@@.@
.@.@@..@.@.@@.......
...@.@.@....@.@.@.@.
@.@...@@@@.@@@...@..
...@.@.@@...@@@.@.@.
.@......@@.@@@@@....
.@@.@.@@.@..@.@.@.@.
@@@.@@@....@.......@
.@@.@.@.@.@.@.@.@.@.
.@....@.@@.....@....
.@.@@......@@.@@@.@.
.....@.@.@.@..@@@..@
12
17 4 0
10 1 0
2 10 0
19 17 0
12 17 1
5 2 1
8 9 1
13 14 1
19 13 2
9 16 2
11 17 2
9 2 2

8 19 0
9 12 0
8 6 0
14 6 0
15 5 1
7 2 1
12 7 1
9 1 1
15 12 2
13 4 2
10 12 2
7 18 2
