width 20
height 20
...@.@@@@@@@@@@@@@.@
.@....@@@.@@@.@@@...
.@.@@@@@...@...@.@.@
@..@.@@.@.@.@.@.....
@@..............@.@@
@.@.@.@.@.@.@.@.@...
..@@@@...@@@...@..@@
@...@@@.@.@@@.@.@...
..@.@@.....@.@@.@.@.
@..@@.@@@.@..@..@@..
@@........@.@..@..@.
@@.@.@.@.@..@.@..@..
@@..@..@@..@..@.@@@.
@..@.@@.@.@@@....@@.
@@........@@..@.@@..
@.@.@.@.@.@.@.@.@..@
@.@..@.@@@@....@..@@
....@...@.@.@@@..@.@
@.@...@.....@@@@....
..@@.@..@@.@@@@..@.@
12
4 19 0
13 13 0
2 12 0
19 10 0
16 11 1
11 4 1
6 6 1
12 16 1
1 8 2
5 18 2
4 1 2
15 17 2

2 4 0
7 17 0
13 7 0
16 2 0
19 13 1
13 15 1
16 11 1
3 10 1
8 18 2
11 9 2
16 16 2
14 16 2
