width 20
height 20
.@...@....@@......@@
.@@.@@@.@@...@@@.@@@
.@@..@....@.@@@..@.@
....@..@@@.@.@.@....
@.@..@.@.........@.@
@@@@.@.@@.@.@@.@@@@.
@@@.......@@........
@@@.@.@@@@..@@.@.@@.
@@@.@@.@.@.@.@@...@.
@@............@@.@@@
@.@.@.@.@.@.@@..@.@@
...@@@.@.@..@@@.@..@
@.@@@@.....@.@....@.
@.@.@.@@.@.@...@@...
..........@@@.@@.@@.
@@.@.@.@.@@@@.@.....
...@..@..@.@.@.@.@.@
@.@..@@@........@...
..@@...@.@.@.@.@.@.@
@..@@.@@@...@@......
12
16 2 0
12 9 0
15 0 0
12 0 0
14 3 1
17 11 1
17 19 1
17 0 1
1 10 2
19 13 2
14 18 2
4 2 2

11 4 0
8 0 0
6 0 0
8 13 0
6 14 1
16 1 1
18 17 1
19 8 1
5 18 2
7 6 2
14 13 2
12 9 2
