width 20
height 20
@@@@@@@@............
@@@@@@@@@.@.@.@@.@.@
@@@@@@@@...@@@@@@...
@@@@@@@@.@@.@.@..@@.
@@@@@@@.........@..@
@@@@@@@.@.@.@.@..@.@
@@@@@@@@...@@@..@...
@@@@@@@@@.@.@.@..@.@
@@@@@@@..@@.....@...
@@@@@@@@.@.@.@@@.@@.
@@@@@@@...........@.
@@@@@@@@.@.@.@.@@...
@@@@@@@@@@@...@@@.@@
@@@@@@@@@@@@.@@@@...
@@@@@@@@@@@@@@@@..@.
@@@@@@@@@@@@@.@.@@@.
@@@@@@@@@@@@........
@@@@@@@@@@@@@.@@@.@.
@@@@@@@@@@@@.....@@@
@@@@@@@@@@@@@.@.@@@@
12
16 1 0
12 16 0
19 13 0
11 4 0
18 6 1
13 16 1
19 16 1
15 16 1
12 13 2
14 4 2
11 3 2
17 12 2

13 4 0
18 5 0
9 1 0
15 7 0
11 3 1
15 16 1
9 10 1
13 16 1
14 6 2
11 5 2
19 6 2
15 15 2
