width 20
height 20
..@@....@....@@.@@@@
.@..@.@@.@@@.......@
.@.@..@@..@..@@.@@.@
.....@.@.@.@.@.@@.@.
.@.@.@..............
..@@.@.@.@.@.@.@.@@.
.@......@.@.@.@@@.@.
..@@.@.@@...@.@@@...
.@.@..@@@@.@...@..@@
.@...@.@@....@..@.@.
@.@@.@..@@.@@..@....
...@...@@.@.@.@@@.@.
@@.@.@.........@.@..
@@..@..@.@.@.@@....@
@..@.@..@@@....@.@..
.@.....@.@@@.@..@@.@
...@.@@...@@@@.@...@
.@..@.@.@@.@....@.@@
@..@....@....@.@@..@
@@...@.@@.@@..@@@.@@
12
7 14 0
2 13 0
6 4 0
12 8 0
15 2 1
19 7 1
0 9 1
6 12 1
12 4 2
4 18 2
18 12 2
11 11 2

18 7 0
2 11 0
10 0 0
13 1 0
4 6 1
8 12 1
5 1 1
6 12 1
18 2 2
11 12 2
19 4 2
14 3 2
