width 20
height 20
.@@@@....@@..@.@@..@
...@..@@....@..@@.@.
.@@@@.@@@.@.@@......
.@@@...@.@.@..@.@.@.
..@.@.@......@.@.@..
.@@....@.@@@.......@
....@@.@@...@.@@.@..
@.@.@.....@@....@..@
@@.@.@.@@@@@@.@..@@.
@.......@@@@@@@@..@.
@@.@.@.@@@@@@.@@@...
@...@@@@.@@@@..@.@.@
.@.@..@...@...@.....
.....@.@.@.@.@.@.@@@
.@.@................
.@@.@.@.@.@@.@.@.@.@
.....@@@.@.@@@@.@..@
.@.@.......@.@....@.
..@..@.@.@....@.@...
@.@@@@@@@@.@.@@..@.@
12
1 6 0
4 8 0
2 1 0
19 3 0
14 11 1
8 14 1
9 7 1
15 19 1
6 5 2
0 17 2
12 0 2
3 16 2

11 1 0
12 12 0
11 4 0
1 1 0
18 14 1
9 17 1
12 5 1
14 2 1
3 15 2
9 7 2
18 2 2
1 18 2
