width 20
height 20
@@@@@@@@@@@@..@...@.
@@@@@@@@@@@@.@.@.@..
@@@@@@@@@@@@......@.
.@@@.@@@@@@..@.@.@..
..@...@@@@.@..@....@
.@.@.@.@@....@@@.@..
........@.@@.@..@@@.
.@.@.@.@@@@@.@.@.@.@
@...@@@...@.........
@@.@.@.@.@@@.@.@.@.@
@..@..........@@@@..
.@...@.@.@.@.@@@@@@@
...@..@@@.@.@@@@@@@@
.@..@@@@@...@@@@@@@@
..@..@.@.@@..@@@@@@@
.@@@......@.@@@@@@@@
@@@@.@.@@....@@@@@@@
@.@.@.@@@.@@.@@@@@@@
.........@....@@@@@@
.@.@.@.@...@.@@@@@@@
12
6 18 0
7 18 0
19 2 0
3 8 0
13 10 1
13 2 1
16 1 1
14 6 1
0 12 2
16 2 2
8 14 2
12 7 2

10 19 0
10 4 0
19 5 0
6 9 0
9 13 1
11 16 1
12 18 1
11 12 1
12 9 2
6 18 2
12 8 2
18 5 2
