width 20
height 20
@@@@@@@@@..@@@.@@@@@
@@@@@@@@@@..@..@@@@@
@.@@@@@@@@.@.@..@@@@
..@@@@@@@@.@...@.@@@
@..@@@@@@...@@....@@
@.@@@@@@.@@...@@.@.@
...@@@@@....@.......
.@@@@@@@.@.@..@.@@.@
...@@@@@..@@.@@@...@
.@@@.@@..@.@@.@.@@..
.......@.@.@.......@
.@@@.@.....@@@.@@@..
@.@...@.@@..@@....@.
@..@@..@.@.@..@.@.@.
..@.@@@@.....@.@@@.@
@.......@.@@...@....
@@.@.@@@....@@...@@.
@..@.@..@.@.@.@@..@.
@@@@.@.@.@..@.@.@@..
@@@@.......@.......@
12
2 15 0
3 12 0
4 11 0
18 8 0
7 17 1
5 10 1
6 15 1
18 6 1
18 9 2
9 14 2
14 3 2
15 18 2

15 4 0
7 17 0
11 17 0
18 18 0
1 17 1
1 3 1
15 2 1
0 3 1
14 2 2
15 9 2
7 12 2
10 16 2
