width 20
height 20
..@@@@@.@@@@@@@....@
.@@@@@..@@@..@.@@@..
..@@@.@..@.@...@@..@
.@.@@...@..@.@...@..
......@@@@....@@...@
@.@.@..@...@@...@.@.
..@@@.@.@@.@.@@@@...
@.@@.......@.@.@.@.@
@@@.@.@@@.@.......@@
@.@...@@.@..@@.@.@.@
....@.@....@@..@....
@.@@.@..@@@@.@@.@@.@
.....@.@............
@@.@...@@.@@@.@.@.@.
....@.@..@@@.@@@.@..
.@.@....@.@...@@..@.
..@@@.@...@@.@@@.@..
.@@@@@..@.....@....@
..@@@@@.@.@.@.@@@.@@
.@@@@@@@...@...@....
12
3 5 0
18 19 0
4 13 0
16 16 0
17 18 1
19 6 1
3 10 1
16 0 1
12 1 2
6 3 2
1 14 2
0 14 2

3 4 0
12 11 0
12 6 0
3 9 0
5 9 1
8 5 1
6 13 1
12 19 1
12 12 2
9 8 2
7 10 2
0 18 2
