width 20
height 20
@@@@@@...@..@@@@@@@@
.@@@@@@.@.@.@@@@@@@@
..@@@@......@.@@@@@@
.@.@.@@@@.@@..@@@@@@
......@@...@@..@@@.@
@.@.@.@.@.@.@.@.@...
...@....@........@.@
.@..@.@..@.@.@.@....
@..@@.@.@@.@.@.@@@.@
@@.@@@..@.@.@.@@.@..
@@@.@.@...........@.
.@@.....@.@.@@@.@...
..@.@.@@...@@@.@@@.@
.@@@@@@.@@..@...@...
...........@@.@..@@.
.@.@.@.@.@..@@@@....
..@@.@@.@..@@@@@@.@.
.@......@@@@@@@@@@@@
..@@.@@...@@@@@@@@@@
.@@@...@@.@@@@@@@@@@
12
12 7 0
6 11 0
2 15 0
13 9 0
5 8 1
4 11 1
10 15 1
0 11 1
11 6 2
18 4 2
10 13 2
8 4 2

0 14 0
13 9 0
15 13 0
7 14 0
10 14 1
0 11 1
19 16 1
11 13 1
16 7 2
18 12 2
10 6 2
15 10 2
