width 20
height 20
@.@.@...@@....@....@
.....@@...@@.@@.@@.@
@.@.@.@.@@@@.@.@@@..
@@@.......@..@.@@..@
@@.@@.@@.@.@...@.@.@
@..@..@......@@.....
.@.@@@.@.@.@....@.@.
..........@..@@..@.@
.@.@.@.@.@@.@...@..@
..@@@@.@..@@.@.@.@..
.@...@..@@.@.....@.@
..@.@@@@.....@.@....
@....@@@@.@@@.@..@.@
@.@.@..@.......@@...
...@..@@@@.@@.@...@.
.@..@..@....@.@@.@@@
.@@.@.@..@.@...@@@@@
...@..@@@@@..@@.@@@@
.@.@.@@.@@.@.@...@@@
.@@............@.@@@
12
0 9 0
4 19 0
16 18 0
10 19 0
9 13 1
4 3 1
6 8 1
19 14 1
12 3 2
10 5 2
1 11 2
0 11 2

10 15 0
13 6 0
6 19 0
12 9 0
14 18 1
8 19 1
16 19 1
14 8 1
18 4 2
8 15 2
6 8 2
3 1 2
