width 20
height 20
@@.......@@..@@....@
@@@.@.@.@@@.@..@.@..
....@@...@....@.@.@.
.@.@@.@.@@@.@.@.....
..@.........@.@.@.@.
.@.@.@.@@.@.@@...@.@
.@...@@.@.@..@.@...@
@.@@.@...@@.@.@.@@..
..@.@.@@.........@.@
@...@....@.@.@.@...@
..@...@.@@@...@..@@@
@.@@.@.....@.@@@@.@@
@@..@@@.@.@.@..@...@
@@.@.@@@.....@.@.@@.
@......@@.@@.@......
@@.@.@@....@@@.@.@@.
@...@@..@.@.@.@.@...
@@.@.@@.@@.......@.@
...........@@@.@....
.@.@.@@.@.@@@@@..@.@
12
11 10 0
12 8 0
17 9 0
1 10 0
5 0 1
0 5 1
11 2 1
13 2 1
7 6 2
2 2 2
18 17 2
3 12 2

12 10 0
2 19 0
14 12 0
7 9 0
6 0 1
11 8 1
14 18 1
17 3 1
13 17 2
9 11 2
11 3 2
13 16 2
