width 20
height 20
..@@@@..@@@@@..@.@@@
.@.@..@..@@@.@....@@
.....@..@@@....@@@.@
@.@.@..@@@@@.@.....@
@@....@.@@@@.@@@.@..
..@.@.@..@.@..@@@..@
@..@....@....@@@.@..
..@.@.@..@@.@..@...@
@....@@.@.@@@@...@.@
@@@.@@@.....@.@.@.@.
@.@.@.@.@.@...@.....
.........@..@.@@.@@.
@@.@@.@.@.@@..@.@.@.
@....@@...@@@...@...
@.@@.@..@..@@.@...@.
.@..@@@..@.@@@..@..@
...@.@@.@...@@.@..@@
.@.......@.@@...@.@@
..@.@.@.@.@.@@.@@@@@
.@@@@@@......@..@@@@
12
1 11 0
19 10 0
14 16 0
13 9 0
9 14 1
11 18 1
12 5 1
17 14 1
5 7 2
6 11 2
3 9 2
13 0 2

14 19 0
16 4 0
8 9 0
9 9 0
10 6 1
0 7 1
5 11 1
1 18 1
12 1 2
14 18 2
16 10 2
3 4 2
