width 20
height 20
@.@.@....@@@@@......
..@.@.@.@@@@@..@.@.@
@......@@@.@.@.@@@@.
..@@@@.@.......@.@..
@.@.@.@.@.@@.@.....@
......@..@....@@.@..
@@@.@..@..@@.@..@..@
@.@.@@...@...@.@.@.@
....@..@@.@.@....@.@
.@.@..@.@..@@@.@....
@@..@...@.@@@@..@@.@
...@.@@....@@..@@...
.@@..@.@@@.@.@.@..@.
...@....@@...@..@@@@
@.@@.@@....@...@.@@@
...@@.@.@.@@.@@@..@@
@.@.@.@@.@@@...@.@@@
..@....@..@..@.....@
@.@.@.@@@...@..@.@.@
.....@@@@.@..@.@@..@
12
12 16 0
14 19 0
18 1 0
15 13 0
18 0 1
10 18 1
0 15 1
13 3 1
11 17 2
15 6 2
3 12 2
9 6 2

4 11 0
18 3 0
6 0 0
3 0 0
14 2 1
12 14 1
18 19 1
1 5 1
11 7 2
12 15 2
1 19 2
2 15 2
