width 20
height 20
@@@..@.@@..@.@.@@@@.
@@.@...@@@.......@..
@..@.@.@...@.@.@@.@.
..@@..@.@.@@@.......
@.@..@...@.@.@.@.@.@
...@...@........@@@@
@.@@.@@.@.@.@@.@@@@@
.........@....@@@@@@
@.@@.@@.@..@.@@@@@@@
@...@....@@...@@@@@@
..@.@@.@.@.@.@.@.@.@
@..@@...@..@........
@@@..@.@.@...@.@@.@.
@@@@......@@.@@@@@@@
@@...@.@.@@@@@@@@@@@
@@@.@..@.@@@@@@@@@@@
@@@@@.@.@.@@@@@@@@@@
@..........@@@@@@@@@
@@@.@@@@@.@@@@@@@@@@
....@@@....@@@@@@@@@
12
9 11 0
18 1 0
10 12 0
10 10 0
6 17 1
7 4 1
1 10 1
18 11 1
13 9 2
5 13 2
14 6 2
12 8 2

12 12 0
10 7 0
4 12 0
15 5 0
4 8 1
8 4 1
13 9 1
1 5 1
7 11 2
18 10 2
4 4 2
8 14 2
