width 20
height 20
.......@....@...@@@@
.@.@.@..@@.@.@.@.@@@
.@@@..@@@...........
..@@@@.@.@.@.@.@.@.@
.@.@@......@.@@...@@
......@@@.@.@.@@.@@@
.@.@.@@@@@........@@
@@.@@.@@@@@.@@.@.@@@
@.@.@..@@@...@@.@@@@
......@.@.@.@.@.@.@@
@.@.@...............
..@@..@.@.@@@@.@.@.@
@..@.@@@@@@.@.@@@@..
..@.@.@.......@....@
@.......@@.@@.@@@@@@
@@@.@.@...@@@.....@@
@@.@@@.@@@.@@.@@.@@@
.......@.@......@@@@
@.@@.@.....@@.@@@@@@
@...@..@.@.@...@@@@@
12
11 7 0
10 3 0
15 8 0
18 11 0
13 19 1
14 17 1
12 8 1
17 4 1
2 7 2
19 2 2
9 2 2
1 8 2

14 3 0
6 18 0
10 19 0
14 17 0
5 4 1
3 0 1
13 16 1
18 10 1
1 18 2
16 5 2
2 17 2
16 6 2
