width 20
height 20
@@@.@.@.........@..@
@@.....@.@.@.@.@.@..
@@.@@.@@@@.@..@....@
@@@.@.@@.@@.@..@.@..
.............@....@@
.@@.@.@.@.@.@..@@.@.
..@@.@...@....@.@@..
.@.@.@@.@@@.@......@
......@.@..@..@.@.@@
.@.@.@.@.@..@@@..@@@
.@@@.......@....@@@@
....@@.@.@..@.@.@@@@
@.@@@...@.@@..@@.@@@
@@@..@@.....@.....@@
@@..@..@.@.@@.@@.@@@
@..@..@.@@.@..@...@@
@@.@.@.....@@@..@@@@
......@.@@.@@@@@@@@@
.@@.@.....@.@@@@@@@@
...@@@@.@......@@@@@
12
12 15 0
13 10 0
7 19 0
7 18 0
5 1 1
10 1 1
19 1 1
4 10 1
7 5 2
12 4 2
6 16 2
1 8 2

4 4 0
14 13 0
0 8 0
3 17 0
12 2 1
16 4 1
10 19 1
12 10 1
7 5 2
10 9 2
10 0 2
3 3 2
