width 20
height 20
.......@............
..........@.........
...................@
....................
........@.@..@...@..
...@.......@........
........@......@....
...@....@.........@.
...............@....
...@......@.........
..@....@............
....@..........@....
...........@.@......
....@..........@....
.......@............
..@.....@...@.......
....................
..........@.........
...................@
......@............@
17
0 10 0
14 2 0
6 7 0
11 2 0
13 15 0
10 14 0
9 2 1
2 19 1
4 14 1
7 15 1
12 0 1
6 14 1
18 3 2
15 12 2
11 16 2
0 0 2
9 12 2

5 4 0
13 1 0
6 2 0
9 3 0
1 0 0
18 0 0
14 10 1
18 4 1
4 15 1
18 6 1
3 16 1
19 0 1
16 9 2
18 9 2
19 14 2
14 19 2
17 2 2
