width 20
height 20
....................
............@.......
...@.@..............
......@.............
@...........@..@....
..@.@.......@@...@..
....................
..................@.
...........@.....@..
....................
.....@...@.@...@@...
....................
...@.....@...@..@...
.....@....@....@....
....................
..........@....@....
...@...@.........@..
..........@.........
...................@
@...................
17
17 13 0
11 1 0
5 5 0
4 1 0
14 8 0
18 5 0
8 13 1
18 14 1
11 14 1
1 17 1
18 2 1
8 1 1
0 11 2
15 6 2
10 6 2
1 15 2
10 11 2

4 15 0
11 1 0
18 19 0
3 19 0
1 17 0
13 19 0
14 12 1
15 11 1
9 17 1
15 7 1
10 11 1
7 17 1
16 1 2
12 17 2
6 8 2
1 15 2
2 15 2
