width 20
height 20
...................@
...........@........
....@...............
................@...
@........@.@........
@...................
....@...............
@..@...@......@.@...
@....@............@.
@..............@....
...........@....@...
@.....@..@.........@
........@...........
....@..........@..@.
.@.@..@.........@...
.......@............
...........@........
.@.@....@.@.....@...
....................
....................
17
3 12 0
14 10 0
16 1 0
1 0 0
19 15 0
16 16 0
1 4 1
3 10 1
17 7 1
6 8 1
12 15 1
12 9 1
3 13 2
12 3 2
14 14 2
2 18 2
11 17 2

0 13 0
1 16 0
1 12 0
14 17 0
13 18 0
17 12 0
11 19 1
7 8 1
3 2 1
18 17 1
10 11 1
4 15 1
2 15 2
14 10 2
3 15 2
9 2 2
1 0 2
