width 20
height 20
........@.........@@
....................
........@...........
@...@..........@..@.
..@..@..............
....@..@............
.@...........@....@.
..@.....@...........
...@..........@..@..
.............@......
......@..@..........
.....@.........@..@.
....................
..@......@..........
.....@..............
...............@...@
...........@........
.....@........@.....
...................@
@@@................@
17
19 3 0
1 15 0
11 14 0
18 18 0
1 18 0
5 2 0
16 14 1
0 1 1
1 14 1
12 0 1
15 2 1
14 11 1
1 4 2
14 5 2
14 19 2
15 19 2
0 16 2

18 4 0
4 6 0
2 0 0
1 10 0
1 3 0
16 19 0
0 9 1
16 14 1
18 1 1
12 12 1
4 19 1
2 14 1
4 9 2
10 9 2
17 18 2
1 12 2
3 18 2
