width 20
height 20
@@.....@.......@....
......@.............
....................
....................
....@...............
..@...@..@..@.......
..@.........@@..@...
....@..@............
....................
..................@.
........@...........
............@....@..
................@...
.......@..@.......@.
..@..........@.@....
....@...............
.......@..@..@......
....................
@..............@....
@@.................@
17
14 17 0
7 8 0
8 11 0
16 1 0
13 0 0
2 3 0
12 9 1
0 15 1
15 2 1
11 5 1
2 7 1
0 11 1
4 14 2
18 0 2
19 2 2
10 3 2
1 13 2

13 18 0
12 0 0
4 10 0
15 1 0
1 17 0
1 10 0
12 9 1
19 5 1
9 19 1
18 5 1
15 5 1
18 15 1
17 15 2
11 12 2
7 11 2
8 4 2
18 4 2
