width 20
height 20
....................
........@...........
.............@......
...@................
........@..@........
.......@.......@....
..@.......@.....@...
......@.@........@.@
.@.@................
.........@...@......
....@...@........@..
....................
.............@......
..........@.........
.....@@.............
....@@@.............
..@......@....@.....
.................@..
...........@........
....................
17
9 2 0
5 11 0
13 18 0
12 5 0
0 16 0
17 15 0
14 15 1
13 4 1
2 13 1
17 5 1
16 13 1
7 3 1
15 1 2
10 17 2
19 11 2
13 3 2
3 19 2

10 14 0
0 5 0
0 1 0
1 17 0
13 15 0
12 14 0
3 15 1
13 4 1
16 3 1
2 4 1
1 5 1
0 7 1
4 13 2
3 1 2
11 15 2
1 16 2
4 18 2
