width 20
height 20
....................
...........@........
..............@.....
...@................
.......@............
....@...@@.....@....
.....@.@.@.@........
....................
.................@..
@@@..@......@.......
@@............@.....
.........@.......@..
...@..........@.....
....................
......@..@...@..@...
.................@..
..@......@..........
.................@..
@@@........@.@.@....
@@@.................
17
6 1 0
10 17 0
6 0 0
3 19 0
3 1 0
8 10 0
14 5 1
16 11 1
14 4 1
11 2 1
3 11 1
19 14 1
5 17 2
15 11 2
13 4 2
2 2 2
8 19 2

1 12 0
3 1 0
7 15 0
19 1 0
16 17 0
19 2 0
0 17 1
9 15 1
2 5 1
12 2 1
16 1 1
2 0 1
19 3 2
18 10 2
7 16 2
15 19 2
18 2 2
