width 20
height 20
................@@@@
.................@@@
..@........@......@@
............@.......
....@...............
.@......@.......@...
@.@@.....@..@.......
....................
..@...........@.....
.............@...@..
....................
......@..@.@....@...
...@................
.........@..........
...@........@..@....
.......@............
........@.@.....@...
....@..........@....
.........@..........
....................
17
15 18 0
10 11 0
5 4 0
17 4 0
5 14 0
2 13 0
14 15 1
15 3 1
1 9 1
9 16 1
9 10 1
18 18 1
3 1 2
6 9 2
7 7 2
11 6 2
12 9 2

15 19 0
10 11 0
14 17 0
1 4 0
16 1 0
19 3 0
11 4 1
2 18 1
3 8 1
16 3 1
0 0 1
2 4 1
1 7 2
1 9 2
10 5 2
9 16 2
13 16 2
