width 20
height 20
....................
....@...........@..@
.............@....@@
...............@@.@@
.........@......@.@@
.............@@.....
.....@.@.@...@@.....
....@.....@.........
..............@.....
@@............@.....
@@...@.....@........
@...................
....@@@..........@..
...@...@..@.........
..................@.
....@...........@...
....................
.......@............
...............@.@..
@......@@...........
17
2 2 0
5 14 0
9 0 0
11 2 0
3 0 0
6 19 0
17 15 1
15 17 1
1 2 1
1 19 1
10 9 1
14 14 1
13 1 2
19 17 2
10 1 2
14 11 2
12 5 2

18 15 0
7 5 0
15 2 0
11 2 0
12 15 0
6 8 0
15 9 1
1 2 1
18 12 1
2 18 1
1 17 1
19 9 1
0 18 2
19 13 2
14 12 2
14 3 2
13 4 2
