width 20
height 20
..@.......@@@@@@@..@
.......@..@.@@@@@..@
....................
....................
......@....@.....@..
...@.......@..@.....
................@...
..@....@.....@......
.....@..........@...
..................@.
.............@.....@
@..@..@.......@.....
....................
......@.@...........
..@..........@......
....................
........@...........
............@.@.....
.....@..............
........@@..........
17
12 4 0
17 19 0
4 1 0
6 6 0
15 14 0
5 14 0
1 15 1
7 10 1
17 0 1
8 18 1
13 2 1
9 11 1
16 9 2
0 10 2
16 16 2
18 1 2
7 13 2

1 19 0
10 8 0
19 19 0
19 18 0
10 11 0
18 17 0
14 10 1
14 6 1
11 3 1
6 16 1
2 4 1
16 15 1
9 1 2
0 10 2
10 3 2
7 0 2
18 4 2
