width 20
height 20
@..........@@.....@@
@......@..........@@
.....@....@.....@...
...@..@.......@..@..
....@...............
........@....@.@..@.
.........@..@.......
..@..@..............
.@...............@.@
..@.................
........@........@..
..@.................
................@...
.....@......@.......
.......@.....@......
....................
.......@..@...@..@..
.....@..............
...@............@...
.@..@......@.......@
17
19 4 0
8 17 0
12 5 0
3 11 0
7 17 0
10 0 0
13 2 1
5 19 1
4 12 1
14 5 1
7 8 1
18 12 1
10 1 2
9 14 2
2 0 2
3 12 2
19 15 2

11 17 0
13 15 0
11 8 0
3 13 0
19 4 0
17 0 0
19 11 1
15 4 1
4 18 1
15 6 1
0 12 1
17 14 1
5 15 2
8 9 2
9 8 2
11 2 2
19 13 2
