width 20
height 20
@@@@@@....@......@..
@@@@@@..............
@@..........@.@.....
......@...........@.
...................@
....@@...@..@.....@@
...................@
....@..@............
......@.@.....@..@..
...............@....
...........@........
................@...
.................@..
...................@
......@............@
....................
......@.@...........
....@...............
.............@.....@
....................
17
11 5 0
2 3 0
6 4 0
17 9 0
8 10 0
7 10 0
4 6 1
11 9 1
11 18 1
1 18 1
5 7 1
0 9 1
10 1 2
5 6 2
7 5 2
8 12 2
6 1 2

3 17 0
0 7 0
9 0 0
1 7 0
4 11 0
15 3 0
16 18 1
1 19 1
14 4 1
5 11 1
18 19 1
5 17 1
1 10 2
11 13 2
16 16 2
15 8 2
3 16 2
