width 20
height 20
....................
....................
....@.....@.........
................@..@
@.................@.
.........@..........
.......@.......@..@.
.................@..
.....@...@........@.
....................
..@.@...............
....................
..........@.@.......
@@.@.........@......
....@....@.....@....
....................
..........@..@......
......@.........@...
..@................@
.............@.....@
17
14 0 0
11 8 0
17 8 0
11 6 0
18 16 0
11 4 0
2 16 1
15 2 1
7 7 1
0 1 1
6 14 1
6 12 1
16 4 2
10 17 2
9 4 2
17 10 2
1 19 2

3 15 0
4 9 0
4 11 0
14 18 0
18 17 0
16 8 0
2 15 1
11 1 1
18 19 1
8 1 1
13 15 1
11 5 1
11 17 2
0 1 2
9 19 2
19 2 2
12 15 2
