width 20
height 20
..@..........@@@.@..
...@.....@..........
..@............@....
......@.............
..........@..@.....@
......@....@........
.@............@.....
..@.................
.....@.............@
..........@.@...@..@
.........@..........
...........@..@.....
..@@..@............@
...............@....
.@..........@.......
.........@..........
..@.....@.....@.....
....................
.....@......@......@
......@.............
17
18 6 0
10 14 0
2 8 0
8 13 0
9 7 0
18 11 0
12 15 1
4 10 1
5 14 1
2 14 1
2 13 1
18 14 1
10 5 2
9 11 2
9 3 2
4 0 2
16 19 2

8 4 0
2 15 0
18 2 0
8 12 0
8 7 0
2 10 0
10 14 1
13 2 1
19 7 1
4 2 1
16 6 1
16 15 1
4 16 2
17 7 2
11 17 2
19 17 2
6 13 2
