width 20
height 20
.@@@...@@...........
..@@...........@..@.
....................
....................
....................
.@.........@........
........@...@.......
...@.........@......
........@...........
.....@...........@@.
..............@.@...
..@.................
...........@........
...@.@...@..........
@.......@...........
....................
............@.@@....
....@..@............
...@...........@@@..
..............@@@@@@
17
17 11 0
3 12 0
11 9 0
16 4 0
11 4 0
10 8 0
1 10 1
8 10 1
11 15 1
10 10 1
15 13 1
14 8 1
13 10 2
3 19 2
9 1 2
14 11 2
2 6 2

17 8 0
8 1 0
10 5 0
3 4 0
19 1 0
19 0 0
18 0 1
16 17 1
7 16 1
6 9 1
4 0 1
15 5 1
13 15 2
11 14 2
19 8 2
2 15 2
19 13 2
