width 20
height 20
....................
....................
...@..........@.....
.................@..
.......@............
..............@.@...
....................
..@...@..........@..
..@......@....@.....
.....@..............
@........@.@........
......@@....@......@
...@....@.....@.@...
.............@......
.............@......
....................
.@@...@....@........
.@@....@.........@..
..........@@.......@
.........@@.........
17
17 5 0
18 2 0
0 16 0
19 3 0
10 2 0
10 0 0
0 14 1
11 14 1
13 16 1
19 12 1
19 0 1
7 0 1
1 8 2
2 19 2
2 3 2
1 2 2
0 11 2

15 15 0
18 2 0
18 17 0
6 19 0
5 16 0
2 12 0
19 0 1
9 18 1
9 17 1
18 16 1
19 9 1
16 8 1
1 3 2
18 1 2
2 3 2
18 18 2
10 15 2
