width 20
height 20
....................
.....@..............
......@....@........
@...@............@@.
.....@.............@
..@...@......@.....@
........@...........
..@........@@.......
......@.@..@@.....@.
...@.....@...@......
...........@........
.@...@.......@......
.......@..@.........
...........@.....@..
...............@....
..@..@.......@.....@
.........@........@@
...@....@.@........@
@...........@.......
@.................@.
17
5 7 0
4 5 0
3 11 0
2 11 0
17 9 0
17 0 0
8 5 1
14 0 1
17 14 1
16 17 1
2 13 1
1 7 1
15 15 2
3 8 2
19 1 2
17 10 2
1 12 2

2 10 0
14 10 0
12 5 0
11 3 0
11 14 0
1 1 0
14 7 1
15 6 1
9 6 1
5 13 1
12 15 1
0 6 1
4 2 2
4 0 2
10 2 2
17 10 2
19 0 2
