width 20
height 20
..................@.
.....@..............
.......@.....@......
......@...........@.
@...@.......@....@..
.............@.@....
.................@.@
............@......@
....................
...........@.@..@...
.......@............
....@...@...@....@..
..@..@..............
..........@.........
.....@......@.@....@
....@@..........@..@
......@......@......
................@...
.@..................
.@..@...........@@..
17
4 6 0
19 4 0
6 8 0
9 18 0
11 17 0
12 15 0
9 0 1
9 9 1
16 11 1
16 18 1
2 17 1
3 0 1
18 10 2
11 18 2
8 17 2
0 12 2
9 12 2

8 19 0
7 5 0
6 6 0
14 9 0
18 1 0
11 19 0
2 8 1
2 16 1
1 1 1
9 4 1
12 15 1
3 3 1
18 8 2
13 7 2
7 9 2
0 13 2
2 4 2
