width 20
height 20
.......@@...........
....................
...............@....
....................
.......@.@.@.@......
.@.@................
.........@..........
...........@....@...
@...@...@..@........
...........@........
....@...@........@..
.........@.@........
...@..........@.....
....................
....@.............@.
..............@.....
....................
....@.......@..@.@..
@.......@...........
@..........@........
17
5 7 0
15 19 0
16 13 0
14 2 0
16 3 0
4 15 0
10 5 1
12 1 1
1 15 1
3 14 1
13 16 1
6 5 1
5 11 2
12 2 2
7 13 2
2 13 2
19 5 2

13 5 0
13 18 0
4 15 0
19 14 0
4 18 0
17 0 0
5 18 1
11 2 1
16 13 1
3 15 1
9 15 1
17 8 1
19 0 2
6 18 2
19 7 2
19 18 2
16 9 2
