width 20
height 20
.......@.......@@...
....................
.@........@....@@...
.................@..
.@...@.........@..@.
.................@..
.........@..@.......
.......@.....@......
....@.....@.........
................@...
........@...@....@..
..@....@............
....@.....@..@......
......@.........@...
...@.@.@............
...............@....
...............@.@..
........@.........@@
..............@@@@@@
@@@...........@@@@@@
17
16 7 0
11 2 0
3 11 0
7 12 0
19 10 0
4 5 0
12 9 1
10 1 1
0 14 1
1 9 1
14 8 1
14 13 1
18 0 2
15 5 2
14 6 2
13 8 2
10 17 2

13 10 0
2 14 0
11 2 0
9 2 0
2 5 0
1 15 0
0 4 1
10 1 1
6 18 1
18 2 1
0 17 1
9 17 1
14 1 2
11 8 2
1 18 2
9 8 2
0 0 2
