width 20
height 20
.........@@@.......@
.@.................@
..@...@............@
...................@
@..@.....@.@.@......
....................
.............@...@..
.@...@..@...........
.............@......
.....@...@........@.
........@...........
...........@........
.........@..........
..............@..@..
....................
.....@....@...@.....
....@.@.............
.@.@..........@...@@
@.............@.@.@@
..............@@@@@@
17
8 17 0
15 9 0
2 12 0
6 3 0
10 16 0
5 5 0
3 2 1
0 3 1
12 9 1
10 5 1
12 4 1
13 5 1
6 5 2
6 11 2
8 2 2
15 12 2
2 6 2

10 1 0
8 17 0
16 11 0
18 16 0
14 3 0
11 9 0
7 13 1
19 14 1
0 13 1
18 15 1
11 19 1
1 12 1
10 5 2
6 9 2
4 19 2
4 18 2
8 9 2
