width 20
height 20
..................@@
....................
...............@....
.............@...@..
......@.............
....@..@.....@......
....................
...........@.....@..
...@....@...........
....................
..@............@@...
....................
........@.......@...
.......@..@.........
...........@..@.....
@..@................
........@...........
@...@......@..@.....
..........@....@@@..
..............@@@@@.
17
0 13 0
8 5 0
18 13 0
8 6 0
18 5 0
2 4 0
3 5 1
2 13 1
12 3 1
8 17 1
5 11 1
1 15 1
17 2 2
6 0 2
9 5 2
0 7 2
0 11 2

2 14 0
9 4 0
13 9 0
12 4 0
3 14 0
4 0 0
2 5 1
0 9 1
18 12 1
1 0 1
4 18 1
15 0 1
8 13 2
19 19 2
19 15 2
0 18 2
11 18 2
