width 20
height 20
..@..@@@@@@.........
....................
.........@......@...
@..@.@.@............
..@.............@...
....................
..@.@....@..@.......
...@......@..@.@.@..
......@.......@....@
...........@.....@@@
........@.....@.....
............@.......
.......@.....@......
....................
............@.@...@.
.......@.@..........
.........@...@.@...@
.........@.@........
........@@..........
........@@@.........
17
7 1 0
14 15 0
18 0 0
14 17 0
6 7 0
7 5 0
5 10 1
1 12 1
16 7 1
11 13 1
19 1 1
11 4 1
11 2 2
16 13 2
14 5 2
19 18 2
13 17 2

14 19 0
0 14 0
16 7 0
15 17 0
5 9 0
9 1 0
16 14 1
18 0 1
9 8 1
11 4 1
12 19 1
1 12 1
1 18 2
5 5 2
1 17 2
14 17 2
13 9 2
