width 20
height 20
..............@.....
....................
....@......@........
...@...@............
.................@..
........@...........
.....@..........@...
...@..@...@....@.@..
.............@......
......@..@.......@..
............@...@...
..@..@.............@
@.....@.............
@...@.......@.......
...@................
.........@..@.......
..........@....@....
...@....@....@......
@...................
@................@@.
17
15 17 0
2 10 0
1 14 0
7 7 0
15 12 0
17 5 0
18 0 1
1 9 1
12 4 1
7 19 1
3 2 1
7 1 1
18 7 2
8 7 2
0 8 2
19 6 2
10 5 2

2 0 0
15 11 0
11 19 0
4 10 0
0 2 0
5 19 0
1 19 1
1 12 1
7 13 1
9 19 1
19 17 1
14 19 1
15 14 2
14 15 2
6 5 2
12 6 2
13 2 2
