width 20
height 20
....................
...............@...@
.@....@.@...@.......
....................
.................@..
...@....@..@........
...@@.........@.....
.@...........@......
.....@.@.@..........
........@...........
..............@.....
....@.............@.
.....@.........@....
............@...@.@.
.........@..........
...@...@............
.....@........@.....
...........@....@..@
...................@
.................@@@
17
7 2 0
3 10 0
8 4 0
10 16 0
16 5 0
10 2 0
11 6 1
13 8 1
3 14 1
16 16 1
0 9 1
4 5 1
16 4 2
2 6 2
16 1 2
4 15 2
2 12 2

13 18 0
6 13 0
7 7 0
6 6 0
19 3 0
9 3 0
0 19 1
1 14 1
5 3 1
13 11 1
11 2 1
3 12 1
0 18 2
12 0 2
16 9 2
6 8 2
4 15 2
