width 20
height 20
....................
.@@......@..........
.@...@.......@...@@.
......@.......@.....
@...................
.....@...........@..
....................
...........@...@...@
.@..@..............@
......@.............
...........@........
.............@.@.@.@
.@..................
@.....@.....@..@....
@..@.......@........
........@...@...@...
....@...............
.....@.......@......
......@.............
....................
17
14 2 0
12 14 0
11 15 0
4 3 0
9 4 0
7 7 0
12 18 1
15 5 1
3 18 1
2 19 1
9 14 1
5 9 1
9 0 2
3 9 2
7 2 2
12 7 2
1 10 2

8 9 0
12 14 0
2 5 0
15 2 0
3 17 0
4 3 0
6 6 1
17 12 1
16 0 1
7 18 1
10 1 1
4 13 1
11 0 2
11 5 2
9 6 2
15 6 2
2 12 2
