width 20
height 20
...........@...@....
....@............@..
..........@.........
........@...@....@..
..............@@....
....@.@.....@.......
@..........@.......@
.............@.....@
....@.@.@..........@
....................
.@......@........@..
.......@......@.....
@.........@.........
....@........@......
.........@..........
....................
.........@..........
....................
.....@@@@@...@....@@
.....@@@@...........
17
10 14 0
16 6 0
12 19 0
17 11 0
5 16 0
18 1 0
4 14 1
11 15 1
12 2 1
11 18 1
13 1 1
1 12 1
11 14 2
18 5 2
9 11 2
6 15 2
5 11 2

1 3 0
15 7 0
0 17 0
6 9 0
14 1 0
15 16 0
16 4 1
9 10 1
18 3 1
7 7 1
11 7 1
9 19 1
16 0 2
17 6 2
19 0 2
9 9 2
7 0 2
