width 20
height 20
@...................
@..@@.@.............
@@..................
..............@.@...
.......@............
.............@......
....................
......@.@..@........
.............@......
........@...........
....@......@........
..@....@............
..............@.@...
....................
..@..........@......
.@...@..............
..@.@...............
........@..@.....@..
.@@.................
....................
17
10 3 0
1 8 0
4 3 0
10 13 0
13 11 0
2 12 0
4 14 1
8 19 1
5 18 1
12 7 1
11 11 1
6 19 1
19 10 2
1 1 2
18 1 2
18 12 2
7 8 2

10 17 0
5 4 0
17 12 0
10 16 0
14 18 0
6 19 0
15 2 1
19 7 1
7 19 1
2 9 1
15 16 1
4 13 1
13 7 2
10 8 2
8 11 2
1 1 2
16 19 2
