width 20
height 20
..@@...@..........@@
..@.........@@....@@
............@@....@@
......@.@.....@...@@
...@...............@
............@.......
....................
..........@....@....
.@...@..............
..........@......@..
......@.....@.......
....@....@.....@....
....@......@..@...@.
........@...........
...@................
...........@........
..@.........@..@....
....................
........@....@......
..@@@........@..@...
17
16 15 0
1 13 0
6 17 0
12 0 0
14 10 0
12 3 0
19 11 1
3 5 1
17 8 1
13 0 1
4 6 1
14 1 1
11 9 2
0 14 2
11 1 2
10 16 2
2 13 2

15 6 0
6 12 0
16 14 0
16 1 0
15 3 0
18 11 0
8 0 1
16 18 1
17 5 1
17 14 1
18 13 1
13 5 1
17 2 2
14 16 2
4 4 2
12 6 2
16 4 2
