width 20
height 20
@@@@................
.@.@................
......@...@.........
.................@..
..............@.....
...@.@.....@.@.@....
......@.............
.@..@..............@
.......@....@...@...
...@.@@...@..@......
..................@.
.........@......@@..
..@.@.....@.........
....................
............@.......
.@....@...@...@.....
....................
@..............@....
...@@@..@...@.......
..@@@@@.....@@......
17
16 9 0
14 8 0
8 13 0
15 0 0
12 16 0
9 9 0
16 17 1
11 12 1
3 16 1
10 1 1
6 11 1
7 12 1
10 14 2
12 2 2
13 14 2
5 8 2
1 16 2

7 16 0
17 6 0
19 0 0
2 17 0
0 8 0
19 11 0
0 5 1
0 4 1
9 9 1
9 3 1
6 11 1
18 19 1
0 12 2
2 10 2
6 0 2
15 13 2
0 9 2
