width 20
height 20
..................@.
....................
......@..@........@.
..@.........@..@...@
.@..@...............
....................
....................
..@.............@..@
........@..........@
...@.....@..@.......
....................
................@...
..@....@............
.........@..........
.............@.@..@.
@................@..
@..@......@...@...@.
............@.......
....................
...........@........
17
3 11 0
14 0 0
2 18 0
16 18 0
9 12 0
13 12 0
18 1 1
8 4 1
11 10 1
6 18 1
8 0 1
17 7 1
14 8 2
2 10 2
4 13 2
18 4 2
9 18 2

9 0 0
16 0 0
17 1 0
3 8 0
3 2 0
16 10 0
13 3 1
9 16 1
6 9 1
16 19 1
19 18 1
9 6 1
10 8 2
0 10 2
17 0 2
7 1 2
18 10 2
