width 20
height 20
....................
.......@....@.......
................@...
.................@.@
..........@.........
..@.................
......@@..@...@..@..
..@........@........
................@...
....@...@....@......
....................
.................@..
.@....@..@...@......
....@.......@....@..
....................
........@.......@..@
.......@.@...@.@...@
...@.......@........
...@@.......@..@....
...@@...............
17
18 1 0
16 7 0
0 1 0
16 3 0
5 4 0
10 14 0
0 8 1
9 8 1
4 16 1
19 11 1
10 15 1
9 10 1
9 15 2
14 3 2
19 2 2
4 7 2
6 7 2

18 5 0
0 7 0
12 19 0
0 14 0
18 18 0
19 13 0
2 3 1
9 1 1
1 17 1
2 18 1
8 4 1
1 0 1
11 10 2
15 0 2
19 18 2
2 9 2
6 7 2
