width 20
height 20
..@.....@...........
..@..........@@@....
....@.@.............
.........@.@........
...............@....
.......@.....@......
........@..@........
..@...@.........@...
.....@........@.....
..........@.........
...@.@..............
....@.@..@.@........
........@...........
..............@...@.
@..............@....
.@@.................
........@.@...@.@...
....................
.............@......
...........@........
17
1 10 0
18 10 0
6 5 0
6 3 0
3 8 0
16 0 0
15 19 1
13 4 1
14 15 1
10 7 1
1 12 1
0 5 1
7 7 2
2 2 2
14 4 2
2 6 2
18 0 2

18 0 0
1 1 0
7 7 0
12 19 0
4 7 0
19 16 0
10 13 1
12 11 1
11 0 1
9 6 1
0 1 1
2 10 1
6 3 2
18 16 2
17 17 2
4 10 2
16 2 2
