width 20
height 20
..@...@...@........@
....@..............@
...........@.....@.@
........@.....@....@
....@......@........
....@...............
....@......@.@......
...@.@..............
....................
.......@...@........
....@...............
..............@.....
....................
..................@@
........@.....@.....
.....@....@.........
....................
.......@........@...
...@................
.............@......
17
8 19 0
11 15 0
17 18 0
13 10 0
3 14 0
13 5 0
5 18 1
6 6 1
10 2 1
18 12 1
0 15 1
17 14 1
2 17 2
18 14 2
5 9 2
0 12 2
5 2 2

17 1 0
8 16 0
11 14 0
5 5 0
4 15 0
12 3 0
3 16 1
6 9 1
11 1 1
1 1 1
3 15 1
10 14 1
2 18 2
1 6 2
5 16 2
1 11 2
16 19 2
