width 20
height 20
@@..@@@.............
@@..................
.......@............
....................
....@...@...........
....................
..@..........@......
............@.......
....................
...@.......@........
.@......@.....@.....
................@...
......@.....@.......
@.............@.....
.........@..........
.............@.@....
.......@............
@@.......@.@..@.....
@@..................
@@@....@@.....@.....
17
6 3 0
8 18 0
9 3 0
14 9 0
13 17 0
17 18 0
10 2 1
0 2 1
12 16 1
17 4 1
12 17 1
0 15 1
4 10 2
1 16 2
6 11 2
19 5 2
2 1 2

17 17 0
17 7 0
13 5 0
13 9 0
17 3 0
3 2 0
3 18 1
2 3 1
16 10 1
18 13 1
1 15 1
10 7 1
7 1 2
17 18 2
5 9 2
8 8 2
7 6 2
