width 20
height 20
@...........@...@.@@
.....@..............
....................
.@..................
.............@.@....
.....@..............
....................
.@..................
.............@.@....
....@.......@....@..
........@....@..@...
...................@
..............@.....
...@...@........@...
.........@..........
..@..............@..
.........@...@......
....@..........@....
.......@............
.......@............
17
6 8 0
11 9 0
12 14 0
6 14 0
16 9 0
9 5 0
14 15 1
8 15 1
0 8 1
7 3 1
16 14 1
17 17 1
6 17 2
13 6 2
17 13 2
9 15 2
1 4 2

15 15 0
10 3 0
0 1 0
14 2 0
1 17 0
10 17 0
12 5 1
6 4 1
19 18 1
16 2 1
12 16 1
14 13 1
17 10 2
14 15 2
2 3 2
2 1 2
3 14 2
