width 20
height 20
...@......@.........
.................@..
....................
....................
.......@........@.@.
....@.@..@.@........
....................
.@.....@...@.@......
.@..........@...@...
....................
....@.....@.........
...@...@@...........
................@..@
...................@
.....@..@........@..
@...........@.......
...@.....@......@...
..............@.....
......@@....@.......
..@...@@@@........@.
17
5 13 0
19 16 0
15 5 0
13 19 0
2 13 0
16 18 0
10 15 1
11 8 1
9 18 1
0 0 1
0 18 1
2 5 1
2 3 2
8 3 2
14 18 2
15 11 2
18 13 2

3 14 0
17 17 0
15 5 0
15 4 0
12 0 0
19 16 0
11 3 1
8 10 1
18 14 1
13 18 1
8 16 1
12 13 1
0 19 2
18 9 2
2 2 2
15 15 2
8 1 2
