width 20
height 20
..........@@@@@..@@@
@...@.@...@@@@@.....
....@........@@...@.
..@...@.............
.@.........@........
..................@.
.....@...........@..
........@.@.........
...........@...@....
.................@..
....................
....................
.@..................
............@@@.....
...@.....@..@@......
................@...
....@...@.@.@.......
...@..........@..@..
....................
.........@......@...
17
9 7 0
7 2 0
1 8 0
16 9 0
14 3 0
15 3 0
2 17 1
18 8 1
8 15 1
15 17 1
6 19 1
0 16 1
11 11 2
19 1 2
12 7 2
3 16 2
14 14 2

10 6 0
12 11 0
13 8 0
5 7 0
0 19 0
1 18 0
17 18 1
6 11 1
10 9 1
0 6 1
7 19 1
19 14 1
3 19 2
1 17 2
3 18 2
18 11 2
8 11 2
