width 20
height 20
..@..@..............
.....@..........@...
............@....@..
.......@............
....................
..............@...@@
........@.........@@
..........@....@....
....................
.............@...@..
.........@.....@....
..@.@.@.@...........
...............@....
........@..@..@.....
.@....@.............
..........@.........
....@...............
...............@....
....................
....................
17
18 16 0
19 7 0
4 10 0
18 10 0
14 7 0
18 4 0
2 14 1
10 8 1
7 12 1
8 12 1
11 0 1
0 14 1
4 17 2
3 16 2
16 17 2
11 14 2
17 14 2

6 8 0
4 15 0
14 15 0
16 5 0
14 7 0
2 16 0
18 2 1
16 19 1
13 13 1
5 13 1
19 12 1
5 5 1
4 18 2
10 1 2
0 13 2
9 8 2
17 14 2
