width 20
height 20
....................
...@...........@....
..........@.........
.....@..............
.........@..@..@....
....................
.................@..
@.........@.........
...@..........@..@..
....................
.@....@.@..@....@...
.......@.@..........
..........@.........
.......@.......@....
..............@.....
....................
......@..@.....@.@..
....................
.........@..........
@...................
17
19 3 0
17 10 0
2 4 0
16 6 0
18 15 0
7 17 0
8 13 1
5 18 1
8 6 1
15 19 1
14 15 1
11 15 1
19 15 2
0 0 2
13 8 2
2 3 2
8 5 2

17 2 0
12 15 0
17 19 0
17 5 0
5 0 0
8 17 0
3 4 1
10 3 1
19 19 1
14 18 1
6 14 1
0 1 1
7 14 2
5 5 2
13 3 2
19 18 2
7 6 2
