width 20
height 20
............@@@....@
.@...........@@....@
.............@......
....................
.@...............@..
..........@.........
...@..@....@........
....................
.........@..........
........@...........
.........@@.@.......
...........@...@...@
..@...@.............
....@.@.......@.....
.................@..
........@..@........
.....@.....@........
..@...@....@..@.@...
............@.......
..................@@
17
17 10 0
12 15 0
6 2 0
17 6 0
9 17 0
2 15 0
11 13 1
1 0 1
15 5 1
3 8 1
14 19 1
18 0 1
4 11 2
17 15 2
3 4 2
11 4 2
11 14 2

15 2 0
17 8 0
5 8 0
9 1 0
5 18 0
7 10 0
0 2 1
17 1 1
8 5 1
15 13 1
14 19 1
0 3 1
19 17 2
18 3 2
10 7 2
0 5 2
0 0 2
