width 20
height 20
@.........@@........
.@............@.....
....................
...........@........
.....@..............
..@..............@..
.....@...@..@.@.....
..@.....@......@....
@...............@...
...@....@..@........
....................
.@....@......@......
....................
......@..@.@........
............@...@...
..@......@..........
....................
...@.@..@..@.....@..
....@.........@.....
........@@@.@@......
17
2 2 0
7 12 0
19 18 0
4 16 0
17 6 0
9 7 0
5 3 1
10 6 1
19 17 1
1 7 1
2 0 1
1 17 1
13 6 2
10 4 2
14 17 2
0 17 2
3 7 2

0 11 0
16 1 0
19 15 0
17 2 0
17 4 0
1 18 0
1 15 1
11 6 1
17 9 1
9 5 1
17 10 1
4 9 1
7 17 2
9 4 2
3 1 2
12 3 2
17 18 2
