width 20
height 20
............@@......
.........@..@...@...
......@.............
..........@..@.@....
...@................
.....@..............
...........@........
.@.@..@...@...@@@@..
....................
..@.......@...@.....
....................
.....@@........@....
......@.@...........
..@.......@.......@.
....@......@........
.................@..
....................
......@..@...@......
................@...
........@...........
17
8 7 0
5 2 0
14 2 0
12 12 0
8 14 0
7 12 0
0 16 1
11 0 1
14 11 1
6 4 1
16 13 1
9 14 1
6 18 2
1 14 2
16 0 2
1 5 2
1 17 2

19 15 0
14 16 0
16 2 0
9 11 0
17 12 0
13 16 0
11 4 1
0 2 1
11 2 1
16 11 1
18 4 1
9 15 1
19 2 2
10 12 2
18 14 2
15 14 2
8 2 2
