width 20
height 20
.........@..........
.........@..........
........@.@..@.@....
.....@.........@.@..
.......@............
...@................
........@.@....@....
@......@...@........
@@..@...............
...@..........@@....
..@....@....@.@@....
..............@@....
......@.............
..........@....@....
...@............@...
....................
...@...@.@....@.....
..........@@....@...
@@........@@@.......
@@........@@@.......
17
3 4 0
2 6 0
17 1 0
11 9 0
18 16 0
16 10 0
7 15 1
3 12 1
16 6 1
11 11 1
17 4 1
18 0 1
7 11 2
19 8 2
16 7 2
8 17 2
0 4 2

10 11 0
11 1 0
12 5 0
19 5 0
5 1 0
9 17 0
0 15 1
18 15 1
4 17 1
9 13 1
11 15 1
2 17 1
16 13 2
3 15 2
19 6 2
4 4 2
13 16 2
