width 20
height 20
...@................
....................
....................
@@.....@.......@....
@...........@.......
@....@...........@..
..........@...@.....
....@..@............
........@....@......
......@.............
...........@.....@..
........@....@......
...@...@............
..........@.@..@....
...@................
@@....@...........@.
@@................@@
@@...@...@........@@
@........@.....@.@@@
.........@...@..@@@@
17
5 14 0
16 2 0
12 19 0
3 7 0
19 3 0
19 5 0
17 12 1
5 8 1
2 6 1
8 19 1
14 9 1
10 0 1
5 4 2
11 11 2
17 16 2
10 14 2
9 5 2

1 4 0
11 16 0
6 1 0
5 4 0
0 7 0
19 7 0
16 7 1
19 0 1
16 13 1
2 11 1
0 19 1
15 1 1
18 14 2
11 11 2
4 2 2
10 2 2
11 5 2
