width 20
height 20
.........@..........
.................@..
.@....@......@@.....
....@...@...........
.........@..........
....@...............
......@.@.....@.....
...............@....
.@........@.........
..............@.....
....@..............@
........@@...@...@..
.....@..@@..........
...@................
............@....@..
...@.@..........@...
....................
......@....@........
.............@......
...@................
17
5 13 0
7 6 0
7 17 0
11 12 0
9 2 0
18 6 0
7 4 1
10 12 1
2 1 1
4 9 1
3 5 1
19 7 1
10 11 2
18 18 2
2 17 2
11 4 2
4 6 2

6 13 0
1 18 0
18 9 0
0 0 0
17 7 0
5 19 0
8 16 1
5 0 1
1 5 1
4 16 1
11 5 1
12 2 1
11 13 2
13 5 2
19 3 2
1 19 2
10 16 2
