width 20
height 20
@.........@.........
....@...............
..@.................
........@..@..@.....
............@.....@.
...@............@...
....................
........@....@.@....
.......@............
....@.......@.......
@..@..........@...@.
....................
...............@....
@..@......@.......@.
@.......@......@....
....................
.....@.....@........
....@....@.....@....
.............@..@...
@......@............
17
15 1 0
7 13 0
3 12 0
8 19 0
8 2 0
3 14 0
3 9 1
9 12 1
16 2 1
7 15 1
17 14 1
4 15 1
11 2 2
10 10 2
17 13 2
3 19 2
15 6 2

12 10 0
2 19 0
6 10 0
15 2 0
14 7 0
12 12 0
5 8 1
11 9 1
7 14 1
7 18 1
11 18 1
7 4 1
12 13 2
12 18 2
3 14 2
10 18 2
0 4 2
