width 20
height 20
....................
........@...........
.......@......@.....
...@.........@......
...................@
......@..@...@.@...@
.............@...@..
.....@..............
.@.........@.@...@..
......@.............
....@....@.@........
.......@....@.......
...............@...@
..@.......@...@.....
.............@......
...@................
....@.....@.........
..............@...@@
......@...........@@
...............@..@@
17
19 11 0
12 16 0
7 12 0
8 9 0
2 6 0
12 19 0
5 15 1
1 1 1
3 4 1
14 11 1
12 12 1
4 6 1
7 16 2
13 10 2
1 17 2
0 9 2
14 3 2

4 9 0
5 4 0
3 11 0
9 9 0
19 16 0
13 17 0
7 9 1
0 0 1
17 17 1
14 14 1
12 14 1
11 19 1
5 14 2
15 9 2
1 17 2
4 7 2
4 18 2
