width 20
height 20
....................
...............@....
..........@..@..@...
........@.........@.
@.........@.........
@.............@.....
@@..................
.@....@....@...@...@
.................@..
......@........@....
.....@.@............
.@@..........@...@..
....@...............
....................
....@...@..@........
....................
...@................
.............@...@.@
..@.................
.....@@@@...........
17
1 14 0
13 15 0
10 1 0
2 12 0
14 18 0
9 16 0
17 7 1
7 8 1
2 16 1
13 8 1
3 12 1
18 15 1
1 2 2
3 14 2
1 15 2
4 13 2
5 12 2

15 15 0
7 14 0
1 18 0
18 2 0
10 19 0
9 17 0
13 16 1
16 11 1
15 4 1
16 13 1
2 9 1
3 0 1
1 2 2
12 4 2
11 18 2
12 9 2
10 13 2
