width 20
height 20
..................@@
.....@....@......@..
..............@.....
@..@.........@......
......@.............
.@.@......@...@.....
......@..@.@........
@................@..
@@.................@
.@.......@...@......
..@..@..............
.........@...@......
.......@............
...@.....@..@.......
@...................
@.......@...........
.....@....@.........
...............@....
....................
..................@@
17
19 18 0
18 15 0
14 0 0
13 0 0
12 16 0
15 16 0
17 19 1
12 18 1
16 5 1
1 19 1
16 7 1
2 13 1
10 2 2
2 15 2
19 9 2
17 13 2
19 5 2

1 13 0
11 3 0
19 5 0
6 10 0
12 19 0
9 4 0
5 2 1
6 18 1
6 16 1
4 10 1
4 15 1
16 1 1
19 9 2
12 2 2
16 5 2
17 13 2
18 13 2
