width 20
height 20
@@@@@............@..
@@@@@@..............
@@@@@@......@.....@.
@@@@@@......@...@...
.@@.................
....@@......@.....@.
........@....@......
..............@.....
.......@..........@.
...........@.....@..
..@......@..@.......
................@..@
@....@..@...........
....@.....@.........
......@.@..@..@.....
.......@....@.......
.....@.............@
...................@
..........@........@
@@........@.......@@
17
5 15 0
8 15 0
16 10 0
10 0 0
18 0 0
1 10 0
6 13 1
14 10 1
15 18 1
18 4 1
16 8 1
11 13 1
9 18 2
7 16 2
18 13 2
3 14 2
7 6 2

9 4 0
0 5 0
7 6 0
7 11 0
4 14 0
11 3 0
12 8 1
18 0 1
17 14 1
19 5 1
13 1 1
1 8 1
9 11 2
13 8 2
10 14 2
11 2 2
6 5 2
