width 20
height 20
...........@........
..............@.....
....................
....@.............@.
.........@..........
.....@.......@......
..@.................
....@..@............
................@...
......@.............
.............@.@....
......@............@
...........@......@.
....@...@...........
.@..................
...........@........
........@...........
..................@.
..........@.....@..@
..................@@
17
12 1 0
5 12 0
7 16 0
4 10 0
4 15 0
13 13 0
5 16 1
16 10 1
0 12 1
2 5 1
4 8 1
1 5 1
3 6 2
6 0 2
17 16 2
2 2 2
8 3 2

13 6 0
1 7 0
5 13 0
14 16 0
13 15 0
5 1 0
16 16 1
14 0 1
3 12 1
13 17 1
4 6 1
4 8 1
0 1 2
17 14 2
0 4 2
7 10 2
19 12 2
