width 20
height 20
...@@.......@.....@.
..@.................
....................
@......@......@.....
@.@.@.........@.@@@.
.............@..@@@.
....@...............
..@......@........@.
......@.............
...@.@..............
.........@.@.@...@..
.@.@..........@.....
...........@.....@..
....@....@...@....@.
......@.............
..........@.........
@............@......
.......@.......@....
.@..................
.@.......@.......@..
17
19 15 0
3 7 0
2 8 0
2 0 0
15 5 0
9 15 0
5 10 1
19 13 1
10 19 1
14 1 1
12 18 1
8 0 1
12 12 2
10 1 2
12 6 2
10 14 2
0 5 2

1 5 0
18 18 0
17 18 0
10 2 0
2 18 0
12 13 0
1 13 1
19 19 1
7 13 1
13 1 1
11 1 1
15 3 1
15 4 2
7 16 2
15 15 2
2 11 2
16 13 2
