width 20
height 20
...................@
...@....@...........
....@...............
......@...@.........
.....@......@@@..@..
............@@..@.@.
.@......@.....@.....
....................
.........@.......@..
............@.......
....................
..@.......@.........
.@.............@....
.........@..........
...@...@.........@..
......@.........@...
..........@.........
.............@......
....................
....................
17
3 3 0
5 17 0
15 9 0
2 2 0
11 15 0
8 12 0
17 13 1
0 2 1
9 1 1
12 17 1
18 15 1
17 19 1
18 2 2
8 18 2
4 11 2
12 18 2
19 7 2

8 13 0
17 10 0
0 19 0
9 16 0
12 15 0
12 10 0
6 8 1
10 17 1
15 11 1
11 5 1
1 19 1
2 2 1
18 3 2
7 16 2
6 1 2
16 0 2
0 6 2
