width 20
height 20
.....@@@.@.@........
......@@............
..@..............@..
..................@.
........@..........@
..................@@
@..........@..@..@..
@@...........@......
@..@................
......@.........@...
........@..@........
..........@...@.@...
.....@..............
..........@.@......@
................@...
.............@@.....
.........@........@.
....................
............@.@.....
...@@@..@.........@@
17
5 8 0
5 2 0
15 15 0
18 9 0
13 4 0
7 17 0
7 10 1
12 14 1
10 8 1
14 9 1
17 4 1
16 1 1
4 11 2
3 17 2
10 12 2
12 5 2
16 19 2

6 10 0
17 0 0
11 19 0
13 11 0
13 17 0
7 19 0
8 17 1
10 3 1
10 5 1
7 4 1
1 15 1
0 14 1
18 2 2
19 8 2
18 4 2
14 5 2
9 6 2
