width 20
height 20
.........@@@.@@.....
...........@........
........@...........
..........@.........
....................
...............@....
...........@.......@
.@..@..@...@........
...........@..@.....
....@............@..
....................
..........@.@.......
...@................
..@..........@......
.......@.@.@.......@
@@..................
@@............@.@...
......@.............
....................
....................
17
1 13 0
7 0 0
14 10 0
19 11 0
5 1 0
19 17 0
18 13 1
8 0 1
19 13 1
16 17 1
18 6 1
17 8 1
9 11 2
0 13 2
15 14 2
8 4 2
9 4 2

17 0 0
13 7 0
13 10 0
11 11 0
4 19 0
17 11 0
10 15 1
16 4 1
18 6 1
1 0 1
18 15 1
8 14 1
2 4 2
0 10 2
4 10 2
18 19 2
0 19 2
