width 20
height 20
..............@.....
.@........@.........
.......@............
.@@.................
...........@..@.....
..@.................
....................
..@...........@.@...
....................
....@....@.@.@......
.....@.@............
........@.@.........
................@...
...............@....
.........@.@........
....@...............
@....@...@...@......
@................@@@
.................@@@
.................@@@
17
17 6 0
13 13 0
6 16 0
15 19 0
10 9 0
0 15 0
1 15 1
2 10 1
1 6 1
9 19 1
15 7 1
2 0 1
1 16 2
8 2 2
7 4 2
14 13 2
4 0 2

1 19 0
3 5 0
6 12 0
12 19 0
19 2 0
7 4 0
3 11 1
3 15 1
1 11 1
10 17 1
2 19 1
9 18 1
19 7 2
17 8 2
17 4 2
15 16 2
4 2 2
