width 20
height 20
....................
................@...
...@................
.....@.@...@........
@................@..
............@.......
...@.@........@.....
....................
.@...@..@..@........
..@..........@.....@
.....@............@.
..@..........@......
......@....@........
....................
...@..@.............
..@......@..........
....................
..............@.....
.@....@..........@..
....................
17
5 9 0
9 18 0
18 7 0
4 19 0
14 15 0
12 6 0
19 15 1
19 3 1
1 17 1
15 5 1
6 2 1
6 1 1
10 14 2
19 14 2
5 15 2
7 19 2
14 13 2

6 10 0
1 2 0
16 5 0
19 3 0
1 3 0
2 17 0
8 4 1
18 4 1
11 2 1
4 15 1
0 12 1
18 12 1
11 5 2
12 13 2
19 2 2
15 13 2
2 2 2
