width 20
height 20
.......@@@@@........
.......@@@@@........
......@@@....@......
..@.................
.........@..........
......@....@......@.
..............@.@...
...................@
....@....@@..@......
.........@@.........
.......@..@..@......
...@.@............@.
.............@......
....................
................@...
@...@........@......
@.............@.....
............@.......
@...................
@...............@...
17
15 6 0
17 5 0
10 4 0
0 2 0
5 3 0
18 14 0
19 4 1
8 8 1
6 13 1
19 18 1
9 3 1
5 5 1
13 3 2
4 11 2
19 1 2
14 15 2
8 3 2

2 19 0
15 3 0
19 19 0
5 17 0
16 5 0
0 0 0
19 5 1
13 14 1
10 2 1
12 3 1
9 3 1
9 15 1
2 13 2
16 4 2
11 16 2
4 16 2
8 3 2
