width 20
height 20
.....@@@@.....@@@@@@
.....@@@....@.@@@...
.....@@@............
...@...@..........@.
....................
.@....@.....@.......
.....@....@.........
.@.............@....
.....@......@.......
@.....@..@......@...
@.@.........@@......
...@................
.............@......
.@...@..@...........
....................
..................@.
.....@.......@.@.@..
....................
@...................
@...@@..............
17
17 8 0
15 10 0
16 13 0
17 4 0
18 4 0
15 12 0
18 5 1
0 15 1
9 12 1
6 8 1
2 4 1
15 6 1
17 2 2
18 2 2
7 14 2
12 17 2
3 4 2

2 9 0
19 19 0
9 15 0
11 11 0
19 6 0
16 11 0
6 19 1
10 2 1
3 6 1
8 15 1
8 8 1
0 17 1
12 12 2
2 6 2
7 14 2
12 18 2
16 7 2
