width 20
height 20
....................
......@.........@.@@
....................
.....@....@.....@...
@@.....@....@.......
....@...............
..............@....@
..@.......@..@...@@@
.................@@@
..............@@.@@@
.......@..@.@.......
...@.......@........
............@...@...
.....@..@...........
.........@......@...
...............@....
...@......@.@.......
........@..@.....@.@
@.........@@.......@
@......@@@@@........
17
19 10 0
4 13 0
12 18 0
3 18 0
18 0 0
5 6 0
6 19 1
2 18 1
6 6 1
5 16 1
12 19 1
14 7 1
0 13 2
8 5 2
9 10 2
18 19 2
3 17 2

15 12 0
17 13 0
16 18 0
15 19 0
13 3 0
0 8 0
3 19 1
8 12 1
2 6 1
15 4 1
4 0 1
2 17 1
0 14 2
18 16 2
0 0 2
9 6 2
2 8 2
