width 20
height 20
..........@@@.......
...........@........
....@...@...........
..@................@
.@..........@..@@..@
...........@.......@
.@...@..@..........@
..........@......@@@
......@.@.........@@
...........@....@.@.
...@..@.............
..@.................
......@......@......
@....@.@............
.........@....@.....
....................
..@.@....@..........
........@........@..
...@................
..@.................
17
15 13 0
11 11 0
2 7 0
2 14 0
6 11 0
3 0 0
10 10 1
5 10 1
4 3 1
19 17 1
6 0 1
18 18 1
18 16 2
5 16 2
2 12 2
13 13 2
12 7 2

15 13 0
19 18 0
5 14 0
0 14 0
16 1 0
6 3 0
12 18 1
5 10 1
3 14 1
15 15 1
13 8 1
3 15 1
3 6 2
9 9 2
19 17 2
3 2 2
1 8 2
