width 20
height 20
..@@@.....@.........
....@...............
.......@....@.@.....
....@....@...@.@....
....................
....@...............
................@...
......@..@.@........
....................
........@....@......
...................@
.....@.@..@.........
...........@.@..@...
..@..@..............
....................
...@................
.........@..........
@@..@.....@.........
@..............@....
@.....@..........@..
17
2 12 0
7 15 0
2 1 0
15 2 0
13 15 0
17 8 0
17 7 1
17 10 1
4 19 1
19 1 1
10 15 1
2 14 1
4 14 2
17 9 2
7 1 2
17 18 2
14 8 2

17 1 0
0 15 0
7 3 0
18 3 0
18 8 0
19 5 0
17 12 1
2 10 1
6 18 1
1 4 1
8 11 1
8 14 1
1 14 2
14 8 2
8 18 2
17 18 2
5 19 2
