width 20
height 20
@@@@@....@..........
@@@@@...............
@@@@@@...@.@.@..@..@
@@@...........@..@..
@@@...@.............
@@@.......@......@..
@@@@...@............
..............@.....
..........@.........
...@.@..........@..@
.........@.@........
....@.......@.......
.........@..........
.@......@..........@
....@.....@.........
....................
....................
.........@..........
.@@.................
....................
17
4 13 0
5 17 0
5 4 0
18 17 0
17 19 0
12 15 0
15 14 1
10 6 1
16 17 1
8 8 1
18 3 1
8 6 1
16 14 2
2 15 2
2 19 2
18 19 2
11 3 2

19 7 0
2 14 0
11 19 0
2 16 0
5 16 0
0 10 0
5 1 1
3 19 1
15 15 1
18 13 1
0 17 1
12 8 1
6 18 2
12 5 2
15 13 2
18 19 2
18 16 2
