width 20
height 20
..........@@@......@
..........@@@.......
......@.....@.@..@..
....................
............@.......
...@............@.@@
....@....@........@@
.....@..............
.......@..@.@.......
....................
........@......@....
....@...............
..@.............@...
.........@..........
..@.@.@.@....@......
....................
.@......@.....@.....
....................
..........@.....@...
....................
17
3 8 0
2 4 0
2 1 0
2 6 0
16 15 0
2 15 0
15 3 1
9 19 1
9 15 1
9 10 1
17 0 1
13 13 1
12 5 2
16 14 2
19 11 2
11 2 2
10 17 2

18 19 0
13 3 0
9 16 0
10 10 0
1 0 0
7 11 0
5 14 1
14 9 1
1 12 1
11 16 1
18 14 1
0 1 1
4 0 2
16 14 2
6 18 2
14 3 2
10 15 2
