width 20
height 20
@@..........@....@..
...@................
....@...............
.........@.....@....
....@..@............
@...................
....@...............
.@.@..@..@.....@..@.
....................
@.@.................
.....@.........@....
.......@............
...@......@.........
................@...
......@.@...........
...........@....@.@.
.@............@.....
......@.@.@.........
@...................
@..............@@...
17
0 3 0
11 11 0
8 11 0
7 5 0
12 12 0
0 2 0
19 4 1
12 15 1
10 3 1
13 10 1
1 2 1
16 7 1
3 14 2
3 2 2
11 9 2
4 10 2
9 12 2

19 14 0
12 11 0
2 0 0
18 5 0
1 3 0
17 12 0
4 16 1
12 19 1
19 15 1
17 9 1
16 17 1
7 18 1
19 8 2
8 3 2
0 1 2
8 2 2
19 0 2
