width 20
height 20
........@@.........@
....@...............
.........@..@@......
..@.......@..@@.....
.........@.....@....
....................
...@.@.....@........
.@..@....@..........
.................@..
...........@....@...
.....@.........@....
...@................
...........@......@.
....@.@.............
...........@..@.....
@...................
....@...............
..@..@...@..@..@....
@.........@......@..
@...................
17
13 14 0
18 15 0
14 10 0
12 18 0
18 6 0
3 8 0
17 5 1
4 8 1
0 13 1
16 15 1
19 19 1
0 0 1
6 9 2
5 18 2
7 18 2
16 10 2
4 6 2

12 14 0
9 11 0
14 7 0
12 11 0
0 17 0
13 19 0
16 1 1
14 19 1
3 10 1
10 8 1
16 17 1
5 1 1
1 0 2
19 5 2
13 5 2
16 19 2
8 13 2
