width 20
height 20
.@................@.
...@..............@.
...........@........
.....@........@.@...
@..............@....
@..@................
@@.........@........
@@@......@..........
@@@.............@...
@@@....@............
@@@........@..@.....
......@.........@...
....................
@........@....@.....
@....@.@..@.@....@..
@...................
....................
.......@............
...........@@.......
...@.......@@.......
17
5 9 0
10 11 0
8 11 0
4 8 0
12 13 0
2 17 0
8 18 1
17 15 1
10 13 1
4 12 1
14 7 1
11 16 1
3 11 2
5 7 2
19 8 2
8 13 2
5 10 2

18 19 0
12 8 0
12 0 0
11 11 0
0 1 0
8 18 0
13 15 1
16 15 1
15 8 1
4 12 1
13 0 1
0 11 1
7 5 2
5 7 2
19 18 2
14 1 2
16 1 2
