width 20
height 20
...............@....
....@.......@.......
.@.@..............@.
................@...
....................
..........@..@......
.@...@.....@........
....@..@...@...@.@..
.........@..........
....................
..@......@....@.....
......@.@...........
..........@....@....
...@..........@....@
........@....@......
...@...@...........@
................@...
....................
......@.............
...............@@...
17
7 5 0
4 12 0
2 1 0
13 15 0
7 18 0
19 14 0
9 18 1
5 9 1
0 13 1
16 9 1
12 2 1
3 5 1
2 2 2
0 11 2
5 4 2
11 9 2
4 13 2

17 16 0
14 11 0
8 7 0
3 4 0
16 15 0
13 2 0
12 9 1
13 18 1
3 14 1
10 0 1
9 7 1
1 5 1
1 1 2
18 1 2
17 3 2
11 11 2
18 8 2
