width 20
height 20
..................@@
@..@...............@
@......@..@...@.@...
.............@......
....................
...@...@........@...
.....@...@..........
...........@........
.............@....@.
...@........@...@...
.@@.................
....@.@..........@..
........@..@........
............@.......
...@.@........@.....
.........@..........
..........@.........
...........@......@.
.@.@...........@....
....................
17
1 1 0
2 4 0
11 6 0
4 14 0
1 16 0
17 12 0
14 8 1
11 13 1
1 17 1
11 4 1
9 9 1
8 4 1
7 4 2
8 16 2
8 15 2
14 18 2
1 13 2

15 3 0
7 15 0
0 19 0
19 17 0
0 3 0
5 1 0
12 8 1
11 11 1
3 11 1
4 16 1
6 5 1
19 18 1
18 19 2
2 3 2
10 19 2
16 17 2
0 14 2
