width 20
height 20
..................@@
.......@.....@....@@
.@.........@...@...@
....@.@.............
...@.......@....@...
..@.................
......@.......@.....
..........@.....@.@.
...@................
.......@......@.....
............@....@..
....@.....@..@..@.@.
.......@............
...............@....
....@...@...........
@........@..@.......
@.@.......@..@......
....................
@@........@....@....
@@..................
17
7 4 0
18 5 0
18 15 0
13 3 0
5 7 0
4 16 0
6 13 1
14 14 1
8 7 1
8 0 1
10 13 1
2 14 1
11 5 2
19 19 2
15 4 2
17 14 2
9 0 2

15 5 0
7 5 0
18 14 0
3 14 0
18 17 0
18 4 0
11 12 1
3 9 1
18 18 1
8 0 1
10 12 1
10 6 1
5 2 2
2 14 2
1 15 2
10 14 2
9 0 2
