width 20
height 20
....................
...........@.....@..
..@@@.@.............
.......@......@..@..
....@...............
.......@............
..@.@...........@...
.@............@.....
.......@..@.........
.........@..@.......
......@..........@..
.....@...@......@...
....................
...............@....
.....@@@...@........
.@@@@@@.....@.......
@@@@@@...@...@...@..
@@@@@......@........
@@@@@...............
@@@@................
17
1 11 0
9 0 0
6 1 0
10 15 0
18 1 0
16 16 0
17 0 1
2 14 1
12 2 1
16 9 1
19 9 1
16 3 1
9 12 2
6 18 2
16 15 2
4 19 2
13 10 2

19 18 0
9 1 0
3 1 0
9 15 0
13 14 0
18 2 0
19 11 1
10 9 1
6 4 1
8 12 1
18 9 1
13 18 1
19 14 2
11 19 2
17 4 2
4 19 2
14 8 2
