width 20
height 20
...@................
......@.........@...
..........@.........
..................@.
......@..@.....@....
...@................
..@.....@..........@
...@.......@.......@
...................@
.................@@@
.@..@..@.@..@...@.@@
........@.@.@.......
....@.......@.......
.......@............
....................
..........@.@..@.@..
....@...........@...
......@....@........
....................
...@@@@@@..........@
17
5 12 0
7 5 0
14 2 0
12 0 0
17 16 0
3 11 0
15 14 1
15 11 1
7 3 1
1 11 1
11 15 1
11 2 1
6 0 2
2 1 2
10 12 2
0 15 2
1 2 2

16 9 0
6 10 0
1 12 0
19 3 0
3 1 0
1 15 0
15 17 1
15 7 1
5 7 1
0 12 1
13 3 1
1 19 1
6 18 2
9 5 2
8 16 2
4 11 2
3 9 2
