width 20
height 20
@...................
@...................
@..@.....@..........
...@...........@....
.....@.@...@........
....................
....................
.........@.@........
.......@............
......@..........@@@
.......@.@.@..@..@@@
...@..............@@
.........@.@......@@
....@...@....@....@@
...............@....
....................
.........@...@......
..@..@..............
.@........@.........
..@...........@.....
17
4 12 0
3 8 0
3 9 0
10 16 0
13 15 0
2 15 0
4 6 1
15 11 1
16 12 1
7 2 1
18 15 1
14 4 1
6 18 2
5 10 2
12 3 2
8 7 2
9 15 2

16 15 0
18 2 0
1 5 0
8 17 0
12 16 0
19 0 0
8 15 1
7 3 1
2 3 1
19 19 1
10 13 1
3 12 1
4 15 2
3 10 2
11 3 2
19 16 2
5 12 2
