width 20
height 20
@......@@@..........
....................
...@..@........@....
...........@.....@..
.................@@.
......@..........@@.
....................
............@.@..@..
...@................
.....@..............
..@...............@.
........@...........
.............@@@@...
..........@.......@.
@....@.@............
...@..........@.@..@
.......@..@.....@..@
..............@.....
........@..@........
.@@@................
17
15 8 0
2 5 0
5 7 0
7 2 0
3 3 0
4 18 0
10 6 1
7 17 1
19 4 1
14 8 1
3 12 1
17 15 1
5 13 2
18 0 2
14 3 2
11 5 2
7 6 2

10 5 0
17 11 0
19 9 0
17 16 0
3 3 0
19 1 0
9 2 1
2 1 1
15 10 1
9 5 1
16 0 1
0 3 1
5 13 2
2 9 2
0 19 2
19 18 2
6 13 2
