width 20
height 20
.................@@@
.................@@@
..................@@
....................
............@.......
.......@.@..........
.................@.@
...................@
........@.@..@......
..@.................
........@...........
..................@.
.......@..@......@..
..............@.@...
......@....@.@......
.........@..........
.....@..@..@........
@............@......
@...............@@..
@@..............@@@@
17
19 13 0
6 16 0
9 11 0
14 12 0
16 3 0
5 18 0
15 2 1
12 10 1
8 3 1
9 18 1
16 11 1
9 3 1
15 12 2
12 16 2
12 13 2
15 16 2
12 12 2

19 13 0
7 17 0
9 10 0
5 1 0
12 12 0
17 5 0
13 3 1
3 19 1
0 8 1
2 0 1
0 1 1
11 3 1
17 10 2
9 16 2
1 6 2
3 4 2
1 0 2
