width 20
height 20
..................@.
....................
....@.@.@...........
....................
....@.........@.....
..@.....@........@..
......@...@.........
..@@@.........@.....
......@..@.@.@......
....................
.......@..........@.
...@..@..@.@....@...
.....@..............
.............@...@..
...@.@..............
.........@....@.....
................@...
....................
.@..@...............
......@...@.@@......
17
3 19 0
2 6 0
11 7 0
19 16 0
16 8 0
17 7 0
10 13 1
18 4 1
12 16 1
1 11 1
18 18 1
2 8 1
1 0 2
12 14 2
5 8 2
16 17 2
4 10 2

6 4 0
4 1 0
14 13 0
16 4 0
3 13 0
8 1 0
19 8 1
0 13 1
7 2 1
1 17 1
0 0 1
6 9 1
16 2 2
13 0 2
5 8 2
1 9 2
19 12 2
