width 20
height 20
............@@...@..
.@..................
.......@............
......@.......@.....
.....@..............
...........@........
...@.@.@............
..@................@
...........@........
.....@...@..........
..@........@........
....@....@....@.@.@.
....................
....@..@...@........
............@..@....
...@.....@..........
.@....@...@...@..@..
.....@..............
...@.@.....@..@.....
.....@..............
17
12 12 0
1 5 0
17 18 0
15 7 0
10 8 0
18 13 0
15 5 1
9 0 1
14 15 1
17 13 1
6 9 1
19 14 1
11 0 2
3 17 2
18 9 2
16 15 2
13 7 2

15 7 0
9 6 0
10 10 0
18 2 0
19 16 0
1 7 0
1 19 1
13 7 1
5 2 1
13 13 1
7 8 1
4 3 1
7 5 2
9 0 2
4 4 2
3 2 2
19 5 2
