width 20
height 20
...........@........
....................
....@...............
...........@.....@..
..@...@..@..........
..............@.....
....................
.@..................
........@..@..@.....
...@................
....................
..@..@......@...@...
...@..@.............
......@.........@...
..........@.........
..@@.......@.......@
........@....@......
...............@...@
...................@
...................@
17
0 17 0
0 16 0
7 8 0
2 19 0
6 7 0
11 5 0
1 19 1
6 6 1
9 10 1
9 14 1
19 5 1
0 0 1
17 12 2
5 1 2
0 7 2
4 11 2
3 2 2

2 1 0
5 10 0
11 9 0
7 19 0
17 18 0
3 18 0
18 0 1
19 14 1
19 5 1
10 16 1
9 18 1
4 1 1
16 12 2
17 19 2
13 13 2
6 9 2
18 17 2
