width 20
height 20
.............@@.....
.........@..@@@.....
..............@.....
..@....@............
...........@.@....@.
.@..................
..@.........@.......
......@..@.....@....
.....@..............
....@............@..
...@................
.....@..............
..............@.....
.....@....@.........
.......@.........@..
.@..................
.....@..@....@..@...
..........@.........
....................
..................@.
17
7 1 0
15 12 0
2 8 0
17 0 0
18 11 0
1 11 0
0 1 1
19 18 1
10 9 1
18 7 1
15 14 1
7 2 1
5 3 2
8 3 2
11 15 2
10 0 2
4 7 2

1 3 0
5 3 0
14 16 0
18 8 0
9 2 0
1 11 0
1 4 1
5 0 1
12 5 1
3 0 1
2 12 1
16 2 1
16 0 2
0 19 2
2 5 2
17 17 2
7 4 2
