width 20
height 20
..............@@@@@@
......@...@...@@@@@@
...............@.@@@
....................
....@@..............
......@.@....@......
...........@........
.@.......@..........
.....@.@............
..........@.........
.....@.@......@...@@
..@............@....
.............@......
@.@.......@..@..@...
........@.......@...
.@.................@
.........@..........
..................@.
....................
.............@......
17
13 14 0
2 0 0
13 8 0
16 10 0
13 7 0
15 4 0
5 2 1
7 12 1
3 15 1
10 5 1
1 3 1
18 7 1
17 11 2
6 6 2
3 2 2
6 10 2
17 13 2

0 10 0
4 10 0
3 0 0
3 3 0
12 6 0
9 12 0
2 2 1
15 14 1
19 3 1
7 5 1
6 16 1
8 7 1
0 7 2
10 0 2
13 17 2
2 0 2
15 12 2
