width 20
height 20
............@.......
....@..........@....
.....@..@...........
.@..................
....@...@...@.....@.
...@..........@.....
@...............@...
@..........@..@.....
@...................
...@@...@..@...@....
....................
........@..@@......@
.............@.@...@
..............@....@
....@......@...@...@
.......@............
.@..@.@.........@...
.........@..........
..............@@@...
......@.......@@@...
17
18 19 0
14 14 0
16 14 0
15 10 0
6 15 0
9 18 0
8 13 1
12 17 1
19 16 1
5 13 1
16 3 1
16 17 1
16 12 2
17 3 2
12 6 2
14 17 2
3 12 2

19 16 0
10 0 0
14 14 0
0 0 0
6 14 0
7 18 0
8 13 1
7 9 1
2 7 1
19 2 1
0 13 1
2 11 1
15 10 2
12 2 2
12 8 2
19 8 2
14 4 2
