width 20
height 20
..............@.....
.................@..
......@.@...........
...@..........@.....
............@.......
......@..........@..
@..............@....
.................@..
.....@.@..@.........
....................
.....@............@.
.........@..........
..............@.....
...@.....@.....@.@..
....................
...@........@.......
.....@...@.@........
....@.....@...@.....
@.................@.
@.................@@
17
13 13 0
7 16 0
5 1 0
10 3 0
8 1 0
19 5 0
9 8 1
3 17 1
15 7 1
4 11 1
14 15 1
3 16 1
1 15 2
9 7 2
10 10 2
8 5 2
9 0 2

5 4 0
7 18 0
16 19 0
8 10 0
12 18 0
10 2 0
8 6 1
1 19 1
17 2 1
12 3 1
10 19 1
19 4 1
11 7 2
9 15 2
7 6 2
7 4 2
15 19 2
