width 20
height 20
....@@..............
....@@........@.@.@.
@...@@@..@..........
....@......@..@.....
......@.............
....................
....................
.....@.@............
.............@.@.@..
......@.@...........
..@.........@@..@...
.@...@...@..@@...@..
..@.................
...@...@..@........@
................@...
..@..........@......
....@.@.............
.......@.....@......
..........@.........
................@...
17
4 15 0
12 8 0
0 14 0
17 2 0
10 19 0
4 12 0
18 3 1
2 13 1
11 2 1
4 9 1
18 13 1
10 11 1
6 19 2
8 0 2
10 4 2
8 12 2
6 5 2

12 17 0
4 18 0
1 16 0
0 16 0
14 4 0
19 0 0
9 1 1
0 0 1
1 13 1
19 5 1
1 18 1
6 8 1
9 18 2
4 4 2
14 19 2
8 10 2
7 6 2
