width 20
height 20
...................@
..............@...@@
..@.............@..@
.....@@.@.@.........
@...................
@...@.@.@...@....@..
..@.................
.........@..........
.....@......@...@...
....@.@.............
............@....@..
..@.....@.....@.....
.....@..............
..................@.
@@..................
...............@...@
....@....@.........@
...........@........
.........@.....@....
@@@@....@@..........
17
18 17 0
19 11 0
18 12 0
9 2 0
16 4 0
17 16 0
6 17 1
10 17 1
15 10 1
1 11 1
5 17 1
16 13 1
5 19 2
13 2 2
4 14 2
3 1 2
9 13 2

19 8 0
5 4 0
0 0 0
11 6 0
0 10 0
10 9 0
5 14 1
14 15 1
15 9 1
4 15 1
15 1 1
17 7 1
4 10 2
17 16 2
11 14 2
17 19 2
18 8 2
