width 20
height 20
....................
....@..............@
..@...........@....@
............@.......
....@...........@...
....................
..@......@@..@..@...
..........@.........
..@....@............
@.............@.....
....@...............
............@...@...
....................
.........@..@.@.....
.................@..
.@...@........@.....
.........@..........
..@.................
.......@........@...
....................
17
8 7 0
15 7 0
19 8 0
8 6 0
18 6 0
7 9 0
8 4 1
15 2 1
17 19 1
6 6 1
5 5 1
5 12 1
19 5 2
17 3 2
15 16 2
19 13 2
12 2 2

2 19 0
2 0 0
13 4 0
19 0 0
1 16 0
5 6 0
15 19 1
1 10 1
17 19 1
12 18 1
18 17 1
18 0 1
6 18 2
1 1 2
12 6 2
19 8 2
0 8 2
