width 20
height 20
..@..........@......
..........@.........
........@.......@..@
.............@...@..
........@..@........
...@................
.....@....@.@...@...
.........@....@.....
.@..................
....................
...@........@.......
..@.@.@..@.......@..
..................@.
..............@.....
............@.......
....@...............
.......@............
...............@....
....@..@............
@....@@.............
17
0 5 0
11 15 0
7 7 0
1 18 0
14 6 0
18 17 0
19 15 1
5 15 1
15 11 1
11 5 1
3 9 1
5 12 1
12 8 2
1 1 2
17 19 2
13 9 2
4 5 2

2 5 0
12 2 0
7 7 0
19 0 0
10 4 0
2 9 0
8 3 1
18 4 1
2 13 1
4 7 1
14 15 1
7 9 1
18 11 2
7 6 2
0 1 2
0 6 2
3 0 2
