width 20
height 20
@...................
....................
....................
........@.....@...@@
...@.@......@..@..@@
.......@.@.........@
.....@....@.........
....................
@.........@....@....
.....@.....@....@...
..@.@........@......
.@...@..............
......@.......@..@..
..............@.....
...@................
.@....@.@.@...@.....
....................
..@.@....@......@...
...@................
....................
17
15 9 0
6 10 0
19 9 0
17 7 0
13 19 0
4 0 0
12 2 1
16 14 1
3 19 1
10 7 1
10 11 1
12 13 1
3 16 2
0 3 2
2 12 2
6 9 2
0 1 2

3 2 0
19 13 0
8 8 0
8 6 0
12 3 0
0 1 0
15 19 1
4 1 1
6 14 1
9 7 1
10 10 1
15 9 1
10 18 2
7 3 2
7 2 2
9 10 2
0 4 2
