width 20
height 20
....................
............@.......
.@.........@..@.....
....@...............
.....@..............
....................
...@.......@..@.@...
..........@.........
.......@.@....@.....
..@....@@....@.@..@.
....@...............
...............@....
.....@.@......@..@..
..........@.........
..............@.....
.............@.@....
.....@..@...@......@
@@@..........@....@@
...................@
....................
17
15 12 0
3 8 0
12 17 0
0 15 0
0 13 0
7 2 0
2 10 1
17 17 1
3 19 1
18 18 1
7 0 1
12 9 1
8 0 2
19 14 2
15 18 2
5 5 2
18 19 2

9 5 0
7 13 0
16 18 0
19 7 0
18 0 0
10 4 0
10 10 1
17 1 1
6 18 1
5 1 1
19 12 1
12 2 1
14 3 2
19 8 2
9 2 2
5 5 2
3 9 2
