width 20
height 20
@@@@........@......@
@@@@................
@@@..@.............@
....................
........@..@....@...
..............@.....
...........@........
..................@.
..@@...@............
.........@..........
...........@........
....@....@.......@..
...@..@........@....
..................@.
........@.......@..@
...........@.@......
..@.@...........@...
...@.@..............
........@...........
.............@@..@..
17
12 7 0
1 6 0
15 5 0
3 11 0
17 16 0
8 9 0
7 18 1
6 7 1
8 11 1
17 12 1
18 6 1
14 11 1
6 4 2
6 8 2
5 0 2
7 9 2
17 4 2

14 16 0
4 10 0
3 19 0
11 3 0
13 7 0
18 14 0
17 0 1
15 19 1
8 11 1
15 13 1
18 0 1
10 11 1
2 18 2
8 8 2
18 19 2
17 17 2
1 19 2
