width 20
height 20
@...............@...
.....@............@.
.........@..........
.........@@.........
.......@.....@......
...@............@...
.............@.@....
....@.....@.@.....@@
.....@.@............
.@.............@....
........@..@........
.........@.@........
.@....@.@...........
....................
..............@.....
....@......@........
..@....@...........@
....................
..................@.
....@...............
17
6 2 0
15 16 0
4 6 0
4 2 0
0 9 0
7 12 0
12 12 1
19 3 1
10 6 1
18 0 1
17 14 1
18 8 1
7 7 2
8 8 2
2 7 2
9 9 2
15 18 2

19 15 0
1 3 0
14 13 0
2 2 0
7 19 0
15 8 0
1 16 1
14 3 1
3 3 1
1 19 1
12 1 1
5 0 1
0 12 2
10 6 2
11 0 2
19 2 2
6 0 2
