width 20
height 20
.@@@@.@@............
......@.............
....................
..@.....@...@..@....
........@...........
.....@..............
..@.................
.............@..@...
.....@......@.......
......@.............
....................
@.@....@...@....@@@.
....@.....@..@......
...............@..@.
...@....@...........
...........@...@.@..
.@..................
@@.@.@..@...........
@@..................
@@..................
17
17 12 0
5 9 0
17 6 0
3 3 0
8 2 0
11 6 0
2 18 1
6 11 1
12 14 1
5 1 1
18 1 1
14 8 1
17 18 2
16 6 2
10 3 2
4 15 2
10 0 2

3 3 0
11 4 0
19 14 0
14 19 0
13 13 0
0 12 0
17 19 1
17 5 1
5 1 1
8 1 1
13 6 1
0 13 1
2 15 2
0 16 2
15 8 2
19 0 2
2 16 2
