width 20
height 20
...................@
........@..........@
.........@..........
......@.............
@@@..........@@..@..
..@.................
@..@...........@....
@...........@.......
@.....@..@.@....@...
@.......@.....@@@..@
.....@........@@....
........@...........
...@...@....@...@...
......@..@..........
..@.................
@.............@.....
@................@..
.............@......
.................@@@
................@@@@
17
17 17 0
8 8 0
10 1 0
14 19 0
5 11 0
3 4 0
17 11 1
4 16 1
8 7 1
10 2 1
5 1 1
14 17 1
2 15 2
9 11 2
6 18 2
3 0 2
12 14 2

1 2 0
2 1 0
0 13 0
18 1 0
19 17 0
17 10 0
4 11 1
16 14 1
11 19 1
17 7 1
4 0 1
18 17 1
8 12 2
14 0 2
6 9 2
17 15 2
9 9 2
