width 20
height 20
.............@@@@@@@
..............@@@@@@
.....@........@@@@@@
....@...@.....@@@@@@
..................@@
..@......@..@......@
.@.................@
....................
.........@....@.....
....................
......@........@....
.@..................
@.......@...@.......
............@.....@.
..@........@@@@.....
@.....@.....@@......
@................@..
@...................
..@..@..............
....................
17
15 4 0
18 5 0
17 12 0
0 7 0
8 2 0
15 9 0
0 11 1
10 18 1
16 5 1
0 3 1
8 13 1
7 18 1
18 14 2
11 2 2
8 7 2
11 9 2
17 18 2

1 10 0
2 19 0
13 18 0
17 12 0
6 7 0
15 8 0
0 10 1
3 3 1
3 18 1
0 3 1
14 6 1
8 14 1
5 10 2
19 18 2
19 10 2
7 16 2
15 11 2
