width 20
height 20
@.....@@............
@.....@@......@.....
@..........@.@......
...@....@......@...@
...................@
........@......@....
....................
@.@.@.....@..@......
@@.....@............
..............@.....
..................@.
@@...@..............
@@.@...........@....
.@.......@..@.....@.
....................
..........@.........
...............@....
....@.....@.....@...
....................
....................
17
6 19 0
3 11 0
6 5 0
7 5 0
18 6 0
14 11 0
3 4 1
17 7 1
16 12 1
12 2 1
18 11 1
15 7 1
18 3 2
9 17 2
18 12 2
19 19 2
17 11 2

1 9 0
8 19 0
3 6 0
18 18 0
6 12 0
6 5 0
6 8 1
15 10 1
6 7 1
15 8 1
2 15 1
15 7 1
3 9 2
11 13 2
18 12 2
7 11 2
6 18 2
