width 20
height 20
...........@........
.........@..........
.@...............@..
....@......@.@....@.
.......@...........@
.....@@.........@...
..........@.........
.....@@@............
.............@..@...
..........@....@....
.....@.@............
....@............@..
@@.......@..........
@.....@.@.@.........
@...................
@@@.....@.@...@..@..
@@...@..............
..@.................
....@...............
@..@.......@........
17
10 8 0
2 0 0
11 2 0
17 3 0
19 3 0
11 14 0
16 10 1
17 18 1
4 12 1
0 10 1
8 5 1
1 5 1
17 0 2
12 11 2
19 10 2
16 14 2
8 9 2

10 7 0
1 5 0
3 11 0
1 18 0
4 19 0
19 0 0
2 1 1
0 4 1
19 18 1
4 5 1
8 6 1
8 9 1
19 11 2
11 9 2
8 18 2
17 13 2
7 11 2
