width 20
height 20
.@@.................
....................
....@.........@.....
....................
.@........@.........
@...@........@......
...@...@.@.........@
....................
.......@........@...
..............@..@..
...........@.......@
..@..@...........@..
........@.@.........
......@.........@.@.
.@..@...............
....................
..........@.@..@....
..@..@............@@
...@............@..@
....................
17
8 14 0
11 12 0
14 10 0
2 2 0
0 14 0
14 12 0
17 5 1
13 4 1
16 17 1
8 11 1
18 0 1
12 18 1
19 3 2
13 13 2
13 3 2
5 4 2
6 14 2

16 10 0
15 5 0
14 17 0
18 18 0
8 4 0
16 16 0
17 12 1
6 19 1
1 9 1
8 0 1
17 13 1
8 18 1
1 15 2
0 18 2
6 17 2
2 12 2
0 1 2
