width 20
height 20
....................
....................
......@.............
..@.@........@......
.........@..........
..................@.
..@........@........
.............@......
.......@............
...@....@...........
...........@........
.........@..@.......
...@................
......@.....@.@.....
....................
.........@..@....@..
.............@......
@@@..@.@.@..........
....................
..................@@
17
3 11 0
4 10 0
17 11 0
11 0 0
15 2 0
15 17 0
18 2 1
8 12 1
18 10 1
13 4 1
2 15 1
15 16 1
5 18 2
4 18 2
10 0 2
0 11 2
6 11 2

11 17 0
19 4 0
19 6 0
1 19 0
12 18 0
3 3 0
8 16 1
4 19 1
8 19 1
2 19 1
2 14 1
10 6 1
5 18 2
5 9 2
9 8 2
17 2 2
18 3 2
