width 20
height 20
...................@
...................@
...@......@.@.@.....
....................
....................
.............@......
.......@....@.......
......@.............
...............@@...
@@..@...............
.........@..@....@..
..@.@..@............
..........@.........
.......@............
........@.@..@....@@
.....@............@@
..............@...@@
...................@
....................
....................
17
2 0 0
15 4 0
8 17 0
9 3 0
0 1 0
4 15 0
9 12 1
5 0 1
16 0 1
12 15 1
19 3 1
9 7 1
15 19 2
17 5 2
17 16 2
0 12 2
3 13 2

6 12 0
18 18 0
8 17 0
15 17 0
14 19 0
13 1 0
7 19 1
16 17 1
9 19 1
17 14 1
18 3 1
1 7 1
7 2 2
18 9 2
2 7 2
6 9 2
16 14 2
