width 20
height 20
....................
...@.@........@.....
..........@.........
....@...............
............@.......
........@.....@..@..
@@@@........@@......
....@..@..@.........
..........@......@..
...@..@....@........
.............@......
....................
......@..@.....@...@
....@.....@.......@@
............@.@.....
@........@..........
@...@.@.........@@..
.............@.....@
.......@.@..........
....................
17
17 10 0
1 17 0
8 9 0
16 3 0
13 9 0
2 8 0
5 3 1
16 6 1
11 15 1
13 13 1
10 11 1
0 10 1
17 1 2
5 16 2
18 10 2
7 12 2
9 8 2

15 8 0
6 3 0
8 9 0
4 19 0
12 8 0
16 19 0
18 16 1
15 6 1
19 6 1
15 15 1
5 0 1
1 0 1
1 15 2
18 8 2
3 3 2
12 2 2
0 7 2
