width 20
height 20
........@@@@........
........@@@.........
......@..@@@.....@..
.........@@.........
.@......@....@......
....@.....@.........
.....@.....@........
...@..........@.....
....................
...@.@....@..@..@...
.@.....@.@..........
....................
.@....@......@......
....@......@.....@..
....................
......@...@.........
..@......@...@@.@...
....................
......@.....@.@.....
...................@
17
16 4 0
1 15 0
6 4 0
7 9 0
10 16 0
14 11 0
19 15 1
8 17 1
13 5 1
1 13 1
15 13 1
10 7 1
1 9 2
4 0 2
2 4 2
16 17 2
15 19 2

15 4 0
10 14 0
18 2 0
14 15 0
2 0 0
1 11 0
7 5 1
19 2 1
1 9 1
15 1 1
15 13 1
16 12 1
9 4 2
13 3 2
3 15 2
19 11 2
3 3 2
