width 20
height 20
........@@..........
........@...........
...@.......@.@.@....
@.@.................
...@..@.............
............@.....@.
........@.....@.@...
......@........@....
...@................
..@...@.............
.....@..............
.....@.......@....@.
.........@...@@.....
@..@................
@...........@.......
...............@....
.....@...@..........
...........@..@.....
.....@...........@..
...............@.@@.
17
13 5 0
6 8 0
16 15 0
14 13 0
6 18 0
5 12 0
18 1 1
19 11 1
11 7 1
9 6 1
6 15 1
3 7 1
17 0 2
9 11 2
11 10 2
2 18 2
11 5 2

1 12 0
13 10 0
0 6 0
9 6 0
19 6 0
17 8 0
15 17 1
1 1 1
10 9 1
14 5 1
5 14 1
3 7 1
0 17 2
16 11 2
9 8 2
19 9 2
10 5 2
