width 20
height 20
.........@..........
.................@.@
..........@.....@...
.@..@..@......@.....
....................
......@..@....@...@.
..@.@...............
....................
.......@....@.......
.........@..........
..@..@.@........@...
...........@..@.....
...@................
..@..........@......
...@...@............
@...@.....@...@.....
@...................
...............@....
......@@............
...............@@@..
17
9 13 0
2 3 0
1 1 0
0 11 0
4 13 0
3 17 0
0 9 1
8 5 1
18 8 1
1 16 1
1 9 1
18 16 1
1 15 2
5 2 2
4 16 2
0 2 2
16 6 2

7 12 0
2 3 0
4 0 0
8 2 0
18 0 0
17 10 0
10 17 1
14 13 1
1 16 1
18 2 1
16 0 1
4 11 1
17 9 2
10 11 2
16 1 2
8 0 2
19 4 2
