width 20
height 20
.@...@@@@@..........
..............@.....
..@.................
@..@................
..........@@@.@.....
...@.@....@@...@....
..........@.........
..........@@.......@
.....@....@@.......@
...............@...@
...@....@...@......@
..@.@...............
...........@.@..@@..
..........@.....@...
..@..@..............
.@.....@..@.........
.........@.........@
...................@
..........@.........
........@...........
17
11 18 0
16 9 0
4 14 0
1 5 0
8 9 0
8 17 0
0 7 1
11 0 1
4 1 1
5 2 1
18 7 1
5 13 1
18 13 2
5 3 2
7 10 2
4 2 2
12 19 2

14 9 0
1 12 0
0 11 0
13 19 0
8 7 0
7 17 0
7 10 1
13 2 1
6 5 1
4 19 1
13 9 1
7 1 1
18 18 2
18 19 2
8 17 2
16 19 2
6 10 2
