width 20
height 20
........@@..........
....................
.......@.......@....
...@..@.@...........
..........@.........
....@........@.@....
............@.......
.......@............
..........@.........
....................
.......@...........@
.........@..@.....@.
.............@..@...
.......@..@.........
....@...............
.......@............
@........@.....@....
.....@..............
...@................
@...................
17
6 4 0
19 2 0
14 2 0
1 8 0
5 2 0
3 19 0
8 14 1
6 7 1
3 6 1
2 11 1
12 3 1
2 3 1
2 15 2
11 12 2
10 16 2
0 7 2
18 2 2

10 9 0
4 10 0
17 10 0
11 9 0
6 18 0
15 19 0
16 3 1
7 9 1
16 11 1
19 11 1
18 18 1
17 17 1
2 14 2
5 6 2
19 3 2
0 11 2
12 4 2
