width 20
height 20
.............@......
..................@@
...................@
.@.................@
@...@..........@....
.........@..........
....................
...@..@...@.......@.
.@..........@.......
......@.............
....................
.....@..@...........
....@..@.......@.@..
.............@......
..........@.........
@...........@.......
@.@.....@...........
@...................
@...........@.......
@@@.................
17
10 10 0
6 3 0
13 17 0
14 0 0
3 8 0
16 5 0
2 4 1
2 8 1
12 4 1
9 12 1
1 16 1
5 1 1
11 4 2
4 0 2
8 9 2
19 10 2
18 11 2

0 7 0
5 0 0
13 16 0
16 2 0
17 16 0
13 8 0
18 11 1
5 19 1
1 17 1
19 0 1
3 14 1
9 8 1
14 6 2
0 12 2
18 6 2
16 12 2
6 11 2
