width 20
height 20
@@.............@....
........@...........
.....@..............
@..........@.......@
....@..............@
......@............@
.............@..@...
.@...............@..
....@.......@.......
...........@........
....................
..@...@......@......
.....@..............
....................
.......@.@......@...
@...........@.....@.
....................
....................
.@@...............@@
.@@................@
17
7 17 0
18 10 0
11 15 0
12 13 0
5 15 0
0 8 0
4 16 1
6 8 1
8 0 1
0 12 1
6 10 1
0 2 1
8 10 2
7 11 2
2 7 2
8 19 2
14 9 2

7 12 0
16 9 0
0 1 0
18 4 0
17 2 0
17 17 0
9 0 1
8 5 1
5 14 1
0 12 1
15 1 1
11 18 1
8 10 2
18 2 2
5 5 2
18 19 2
1 1 2
