width 20
height 20
........@......@....
..@.................
.....@..@...........
......@.........@...
........@...@.......
...@.....@.@........
....................
...@........@......@
.....@..............
..............@.....
....................
@.@..@.@........@...
....@....@..........
.......@..........@.
............@.......
....@......@......@.
.............@......
..........@.........
..@..............@..
....................
17
7 9 0
12 19 0
9 10 0
10 6 0
13 9 0
12 10 0
8 18 1
2 13 1
13 7 1
14 5 1
7 7 1
17 8 1
12 9 2
5 5 2
1 18 2
14 11 2
19 9 2

19 6 0
13 12 0
18 1 0
0 19 0
15 12 0
14 11 0
17 12 1
19 0 1
5 6 1
14 5 1
7 7 1
4 7 1
4 18 2
16 19 2
2 16 2
12 10 2
6 6 2
