width 20
height 20
...................@
.............@......
@...@.........@.....
@...................
...........@.....@..
.@.@..@......@..@...
.........@..@....@..
..............@.....
....................
.....@..............
..........@..@......
.........@..........
....................
..@............@....
........@.....@.....
..@..........@......
.................@..
@.....@....@...@....
@..................@
@..........@@@.....@
17
5 12 0
15 14 0
13 16 0
8 0 0
13 11 0
14 6 0
12 13 1
1 16 1
19 6 1
7 12 1
19 4 1
1 2 1
2 14 2
7 19 2
16 4 2
10 11 2
19 3 2

15 18 0
9 18 0
17 1 0
10 9 0
8 3 0
19 6 0
7 17 1
18 2 1
13 18 1
17 17 1
19 1 1
0 9 1
12 1 2
7 19 2
19 3 2
10 12 2
18 4 2
