width 20
height 20
@...................
...........@........
..@......@@.....@...
....@...............
....................
....@......@....@...
..@.........@@......
.......@@...........
..@.@...........@...
..........@..@......
..............@.....
.......@........@...
....................
..........@..@......
.......@.......@@@..
..@...@..@..........
............@....@..
...@................
....................
....................
17
17 19 0
0 19 0
17 15 0
11 8 0
19 14 0
2 17 0
15 13 1
15 19 1
19 15 1
2 9 1
4 17 1
11 18 1
14 2 2
18 5 2
1 6 2
5 19 2
0 8 2

2 10 0
1 19 0
0 4 0
9 7 0
1 6 0
4 19 0
11 18 1
10 0 1
9 6 1
9 18 1
9 5 1
12 18 1
0 15 2
2 16 2
2 17 2
6 18 2
2 7 2
