width 20
height 20
@......@@@@@.@.@..@@
@@.@.@@.@........@@@
@@..@@....@.@@.@.@@@
@.@..@@.@..@...@@@@@
....@.@..@@.@.@...@@
@.@.....@.@.....@.@@
..@.@.@...@@.@@@.@.@
@@@@@@@@.@@...@.....
.@@.@.@.@@.@.@..@.@.
..............@.@@..
.@@.@.@.@@@@@.....@.
...@.@@.@.@.@.@@@@@.
@@.....@.....@...@@@
@..@.@@..@@.@.@@..@@
@.@.@@.@..@......@.@
.........@.@.@.@....
@.@.@.@.@...@@@..@@.
@@...@...@.@.@.@.@.@
@@@.@@@@.....@......
@@@@@@...@@.@@@.@.@.
14
16 2 0
10 3 0
13 4 0
12 1 0
16 12 0
15 9 1
0 11 1
15 5 1
15 1 1
3 14 1
11 4 2
3 10 2
11 9 2
13 5 2

7 1 0
5 15 0
15 16 0
7 16 0
11 16 0
19 19 1
3 14 1
15 4 1
4 12 1
8 18 1
9 14 2
10 15 2
11 19 2
14 1 2
