width 20
height 20
@@@@@@@@@@@@@@...@..
@@@@@@@@@@@@@@.@...@
@@@@@@@@@@@@@@@..@@.
@@@@@@@@@@@@@@@@....
@@@@@@@@@@@@@@@.@@@.
@@@@@@@@@@@.........
@@@@@@@@@@@@.@@.@.@@
@@@@@@@@@@@....@.@@@
@@@@@@@@...@.@....@@
@@@@@@@.@.@.@@.@@...
@@@@@@@.......@@..@.
@@@@@@..@.@@.@@@@..@
@@@@@@@..@@.@@.@.@..
@@@@@@..@..........@
@@@@@@@.@@.@@.@.@.@@
@@@@@@@.@....@.@.@.@
@@@@@@@..@.@........
@@@@@.@.@@@@.@.@.@.@
@@@...........@@@...
@@@@.@.@.@.@.@@@@@.@
14
11 18 0
11 15 0
11 13 0
19 10 0
17 16 0
16 7 1
18 0 1
6 18 1
10 14 1
16 3 1
13 13 2
12 16 2
8 16 2
12 11 2

15 16 0
19 0 0
16 16 0
18 5 0
12 16 0
7 18 1
18 0 1
15 5 1
10 18 1
16 2 1
17 5 2
14 8 2
12 15 2
7 16 2
