width 20
height 20
@..@@@@@@@@@@@@@@@@.
.@..@@@@@@@@@@@@@@..
...@@@@@@@@@@@@@@.@.
.@.@@@@@@.@@@@@@@...
..@@@@@....@@@.@..@.
.@.@@@@.@@..@....@..
....@@.@.@.@.@.@@.@@
@@.@.@.@........@.@.
@@......@.@.@.@.....
@@@.@@.@@..@.@.@.@@.
@@@@.@..@.@........@
@@@@...@.@.@.@.@.@.@
@@@..@@.......@@@.@@
@@.@...@.@.@.@.@....
@....@@...@....@.@.@
@@.@.@.@.@@@.@..@...
@@@.......@@@..@.@.@
@@@@.@@.@.@@@@......
@@....@@..@@@..@.@.@
@@.@@@@@@..@@@.@@...
14
3 9 0
8 4 0
14 9 0
14 11 0
3 16 0
16 11 1
16 16 1
17 7 1
18 10 1
5 13 1
7 8 2
13 12 2
10 4 2
2 19 2

7 12 0
14 14 0
10 6 0
0 5 0
3 16 0
8 12 1
19 2 1
4 18 1
17 15 1
14 16 1
11 12 2
10 9 2
17 19 2
4 17 2
