width 20
height 20
@@@@@@@@@@@@@@@@@@@@
@@@@@@@@@@@@@@@@@@@@
@@@@@@@@@@@.@@@@@@@@
@@@@@@@@@@...@@@@@@@
@@@@@@@@@@@.@@@@@@@@
@@@@@@@@@@..@@@@@@@@
@@@@@@@@@@@..@@@@@@@
@@@@@@@@@@..@@@@@@@@
@@@.@@@@@.@..@@@@@@@
@@@..@@@....@@@@@@@@
@@.@.@.@@.@@.@.@.@@.
@...................
.@@.@.@@@.@.@.@.@.@.
.@...@@@@..@@@..@@..
..@.@.@@.@@.@.@..@@.
@.@.......@.@..@@.@.
....@.@.@.@...@.@...
@.@..@@@..@.@.....@@
...@@....@.@@.@.@.@@
@.@@@@@@.....@@@@.@@
14
12 11 0
1 16 0
4 11 0
4 17 0
10 7 0
15 18 1
16 10 1
11 9 1
3 15 1
11 17 1
9 8 2
4 10 2
2 13 2
10 11 2

19 10 0
3 17 0
17 18 0
5 16 0
11 9 0
8 18 1
1 11 1
5 12 1
3 13 1
10 9 1
2 11 2
9 9 2
2 13 2
13 17 2
