width 20
height 20
@@@@@@@@@@@.@.@@@@@@
@@@@@@@@@@.....@@@@@
@@@@@@@@@@@.@.@@@@@@
@@@@@@@@@@...@@@@@@@
@@@@@@@@@@@.@.@@@@@@
@@@@@@@@@@....@@@@@@
@@@@@@@@@@@.@.@@.@@@
@@@@@@@@@@@@......@.
@@@@@@@@@@@@.@.@@@..
@@@@@@@@@@@@..@@.@.@
@@@@@@@@@@@@@.......
@@@@@@@@@@@@@@.@.@@.
@@@@@@@@@@@@@@@@.@.@
@@@@@@@@@.@@@.......
@@@@@@@@...@@@.@.@.@
@@@@@@@@.@@.@...@...
@@@@@@@.......@@.@.@
@@@@@@..@.@.@..@....
@@@@@@@..@...@..@.@.
@@@@@@@.@@@.@..@@.@.
14
8 18 0
11 6 0
8 15 0
19 13 0
14 15 0
13 17 1
15 15 1
13 9 1
16 6 1
10 16 1
16 7 2
16 14 2
19 8 2
12 8 2

9 16 0
19 10 0
6 17 0
19 13 0
16 16 0
13 7 1
13 0 1
11 18 1
18 12 1
13 2 1
14 13 2
16 11 2
18 9 2
15 15 2
