width 20
height 20
@@@@....@@..@@@@.@..
@@@@@.@.@..@.@@..@.@
@@@@@@@..@.....@....
@.@@@@@@...@.@...@@.
...@@@@..@@@@..@..@.
.@@.@.@.@.@@.@@..@..
..............@@..@@
.@.@.@@.@.@@.@@@@.@@
..@.@..@.@..@@@@.@@@
.@@.@@.@.@@..@.@..@@
.........@.@.@.@.@@@
@.@.@@.@..........@@
.@@@..@@.@.@.@@.@..@
..@.@.@.@..@...@..@@
@.......@.@.@.@.@@.@
.@.@@.@..@..........
...@@@..@.@.@.@.@.@.
.@...@@......@@@@@..
.@.@@@@@@.@.@@.@@.@.
@@.@@@@....@@.......
14
9 14 0
12 10 0
9 6 0
11 0 0
7 17 0
8 6 1
10 0 1
3 17 1
1 8 1
4 14 1
17 12 2
18 19 2
0 7 2
5 8 2

14 4 0
8 19 0
7 19 0
10 11 0
11 14 0
7 10 1
9 1 1
3 9 1
5 0 1
17 15 1
8 2 2
9 18 2
1 13 2
2 18 2
