width 20
height 20
@......@@@@@@@@@@@@.
@.@.@.@@@@@@@@@@@@@.
...@@@@@@@@@@@@@@...
@.@@@@@@@.@@@@@@@.@.
...@@@@....@.@.@.@..
@.@.@@.@@@.@.......@
.......@@@.@.@.@.@..
@.@@.@..@....@..@..@
@...@@.@@@.@.@@@.@..
.@.@@...@@@.@.@@...@
..@..@.@.@@.@....@..
.@.@..........@.@..@
.....@.@@@.@.@@@.@..
.@@.@.@@....@......@
.@@@@.@@@@@@..@.@@.@
.@@.@..@....@.@@.@@.
.@....@.@.@.........
..@.@.....@@@.@.@.@.
.@@@..@.@.@@@@...@..
@@@@@..@@@@@...@..@.
14
1 1 0
18 11 0
17 2 0
11 16 0
16 9 0
5 15 1
5 16 1
1 6 1
13 13 1
18 13 1
9 3 2
2 8 2
14 7 2
18 10 2

16 19 0
8 17 0
5 13 0
0 12 0
14 18 0
4 10 1
19 2 1
14 5 1
3 15 1
4 6 1
3 0 2
5 18 2
0 4 2
10 15 2
