width 20
height 20
@.@.@.@.@.....@@....
@.........@.@...@.@@
..@.@@.@.@...@.@@..@
.@....@...@.@.@@@@..
..@.@..@.@.@...@@..@
.@@@..@....@@.@@@@..
..@@@.@@.@.....@@@.@
.@.@.@.@@@@.@.@.....
.........@@.@@..@.@.
@.@.@.@@.@.@@.@..@.@
...@@@..........@..@
.@@@@@@@.@@@@.@...@@
..@@@@@@@@@...@.@..@
.@@@@@@@@@@@.@@@..@@
@@@@@@@@@@@...@.@.@@
@@@@@@@@@@@@.@.....@
@@@@@@@@@@@@@.@.@.@.
@@@@@@@@@@@@...@....
@@@@@@@@@@@@@.@.@.@.
@@@@@@@@@@@@......@.
14
13 9 0
15 7 0
16 17 0
15 18 0
7 10 0
14 4 1
1 9 1
17 11 1
0 11 1
1 2 1
10 10 2
17 1 2
17 12 2
8 10 2

3 2 0
6 4 0
17 17 0
3 4 0
13 18 0
14 4 1
15 14 1
9 5 1
3 9 1
19 19 1
17 12 2
14 6 2
13 4 2
11 0 2
