width 20
height 20
.@.@..@..@.@.....@@@
...@.@@@....@@@@.@.@
.@....@.@@.@.@.@.@.@
..@@@.@..@.......@.@
.@.@.@..@..@.@.@...@
.@...@.@.@@@..@@@.@.
...@.........@@@.@..
@@..@.@@.@.@..@..@.@
...@.@.@@.@@@@.@...@
.@........@......@.@
..@.@.@.@@.@.@.@..@.
@@@@@@..@..@.@@..@..
..@.@.@.@.@.@.@.@.@.
@.@.@.............@.
......@.@.@.@.@.@...
@.@.@..@@@@@@@...@@@
...@..@@@@@@@@.@....
@.@@@..@@@@@@@@.@.@.
...@..@@@@@@@@....@.
@.@..@@@@@@@@@@.@..@
14
17 17 0
2 14 0
3 14 0
7 11 0
8 13 0
18 9 1
8 5 1
19 18 1
10 3 1
1 8 1
6 5 2
16 16 2
13 5 2
1 13 2

12 7 0
14 13 0
13 12 0
4 1 0
8 3 0
0 2 1
7 11 1
12 0 1
16 4 1
1 8 1
2 6 2
1 12 2
7 13 2
18 14 2
