width 20
height 20
@@@@@@@@@@@@@.@.@.@.
@@@@@@@@@@@@........
@@@@@@@@@@@@@.@.@@@.
@@@@@@@@@@@@.@...@@@
@@@@@@@@@@@@..@@....
@@@@@@@@@@@@@....@.@
@@@@@@@@@@@.@.@@@@@@
@@@@@@.@@@....@@@@@@
........@..@.@@@@@@@
@.@.@@.@.@..@@@@@@@@
...@@@.....@@@@@@@@@
@.@.@.@.@@..@@@@@@@@
@......@@@.@.@@@.@@@
..@.@.@@@.....@...@@
@..@...@@@.@@@.@@..@
@.@@@.@.@..@.@....@.
..@.@@@...@....@@.@.
@....@@@@..@@@.@@...
@.@@@.@.@.@.@....@@.
...@..........@.@@..
14
0 10 0
9 19 0
0 13 0
16 12 0
6 14 0
11 18 1
16 1 1
14 17 1
7 8 1
8 16 1
11 13 2
10 14 2
15 19 2
3 8 2

15 2 0
15 19 0
18 17 0
13 19 0
7 19 0
1 17 1
14 17 1
12 7 1
17 15 1
7 11 1
9 10 2
10 17 2
14 18 2
12 8 2
