width 20
height 20
@@@@@@......@@@@@@@@
@@@@@.@.@@.@@@@@@@@@
@@@@...@.@...@@@@@@@
@@@@.@...@.@@@@.@@@@
.@@..@.@.....@...@@@
....@@@@.@.@@.@@.@@@
@@.@.@.@@.@@..@..@@@
..........@.@..@..@@
.@.@.@.@@.....@@.@.@
..@...@@.@.@.@@.....
.@@@.@@...@@@@..@@.@
@....@.@.@....@@.@.@
@@@@.......@.@@@....
.@@@.@@.@.@......@.@
.@@.@..@@@.@@.@@@...
......@.@........@.@
@.@.@.....@.@.@@..@@
...@@@@.@..@@@...@@@
@.@.@@.@@@.@@@@.@@@@
@......@@@@@@@@@@@@@
14
10 0 0
7 13 0
8 11 0
4 12 0
18 13 0
1 17 1
0 4 1
0 7 1
8 2 1
1 18 1
7 1 2
2 17 2
8 7 2
9 12 2

10 0 0
3 19 0
7 12 0
9 15 0
12 2 0
15 15 1
18 12 1
14 7 1
10 1 1
11 15 1
8 5 2
4 13 2
2 5 2
9 0 2
