width 20
height 20
@@@@....@...@.@@@..@
@@@.@@.@@@.@...@@@..
@@......@@...@@.@..@
@@.@.@.@...@.....@..
@@.@.@@..@@..@.@...@
@@..@@.@@.@@@.@..@@.
@@.@......@.....@...
@...@.@@.@.@.@@@.@@.
.@.@.@@.......@.....
........@@.@.@@@.@.@
.@.@.@@.@.@..@@...@@
@..@@.....@.@@..@@.@
.@...@@.@@..@@@....@
...@@...@@.@.@.@.@@@
@@..@@.@..........@@
@.@@.@@.@.@.@@.@.@@@
...........@@@@.....
.@.@.@.@.@..@@@@.@.@
..@.@...@..@@@@@@...
.@....@.@@.@@@@@@@.@
14
3 1 0
11 6 0
5 7 0
2 13 0
11 17 0
2 5 1
17 6 1
13 0 1
4 16 1
11 4 1
3 2 2
18 16 2
7 2 2
10 1 2

5 7 0
1 13 0
9 6 0
10 13 0
12 13 0
16 15 1
11 11 1
10 1 1
8 3 1
9 8 1
14 6 2
18 3 2
18 12 2
2 17 2
