width 20
height 20
......@@@...@@@..@@@
.@.@.@@@.@.@.@.@.@@@
.@@@@@@...........@.
.@.@.@.@.@@.@.@@.@..
.@.@....@....@.@...@
.....@.@.@@.@....@..
@.@.@.@..@..@.@.@..@
@@....@.@@@@.@.@.@..
@@@.@...@..@.......@
@@@@.@.@.@...@@.@.@.
@@@@......@@.@@@....
@@@.@@.@.@.@.@@@@.@.
@@....@.......@@@@@.
@@@.@..@.@@.@...@.@@
@@@.@.@@@..@@.@.....
@....@@@@.@@.@..@.@@
.@@.@.@.@.@...@.@...
....@......@.@.@..@@
@.@...@@.@.......@.@
...@.@@...@.@@.@....
14
11 5 0
18 19 0
12 12 0
18 16 0
6 13 0
14 18 1
10 1 1
17 6 1
16 8 1
19 5 1
6 17 2
13 2 2
15 5 2
12 7 2

17 9 0
9 15 0
3 16 0
18 16 0
6 13 0
4 18 1
4 5 1
9 19 1
9 17 1
0 4 1
6 8 2
18 4 2
16 4 2
10 11 2
