width 20
height 20
@@@@@@@@@@@@@@@@@@@@
@@@@@@@@@@@@@@@@@@@@
@@@@@..@@@@@@@@@@@@@
@@@@@@..@@@@@@@@@@@@
@.@@.@.@@@@@@@@@@@@@
.......@@@@@@@@@@@@@
@.@.@.@.@.@.@@@@@@@@
...@......@.@@@@@@@@
@@..@@@.@....@@@...@
@.@@...@..@@.....@..
...@.@@..@@..@.@@..@
.@.@...@..@.@.@.@@.@
..@..@...@@......@.@
.@.@.@@@.@..@@.@..@.
.....@@...@...@@@...
.@.@.@@@.@.@@@@...@.
@@..@.@@@.......@.@@
@@@....@@@.@.@.@.@.@
....@.@@.@@..@...@..
.@.@.......@.@.@...@
14
6 9 0
5 16 0
9 11 0
1 6 0
4 9 0
0 15 1
11 16 1
13 14 1
8 9 1
7 14 1
9 6 2
5 11 2
14 12 2
1 5 2

15 16 0
18 10 0
12 17 0
18 14 0
17 15 0
14 17 1
10 19 1
16 8 1
14 16 1
15 18 1
16 17 2
13 11 2
0 11 2
18 8 2
