width 20
height 20
@@@@@@@.@@@@@@@...@@
@@@@@...@.@@@@.@.@@@
@@.@.@@....@@@......
.....@.@@@..@..@@.@@
.@.@.....@.@.@..@...
..@..@.@.......@..@.
@.@.@...@.@.@.@@@..@
..@@@@@@@@@@..@@@.@@
@.@.@.@.@....@.@.@@@
........@@.@.@...@.@
@.@.@.@..@..@@.@....
@..@.@@.@.@...@.@@@.
@.@..@....@.@@@.....
....@@@.@.@@.@.@@.@.
.@.@@@.@...........@
..@.....@@.@@@.@@.@@
.@@.@@.@..@......@.@
...@.@.@.@@@.@.@....
.@........@@..@.@.@.
..@@.@.@.@...@@....@
14
8 10 0
6 5 0
2 18 0
7 11 0
11 11 0
12 17 1
5 10 1
5 9 1
10 15 1
11 14 1
3 5 2
14 8 2
14 16 2
2 17 2

6 9 0
13 6 0
1 7 0
9 12 0
16 10 0
12 18 1
14 5 1
9 18 1
4 5 1
8 19 1
9 2 2
19 13 2
5 1 2
8 10 2
