width 20
height 20
@@..@@@.@@@.......@@
@@.@@.@.@@@@.@.@@..@
@..@@.....@@..@@@.@@
.@..@.@.@.@.@@.@@.@.
...@..@@@@..........
.@@..@@@@..@.@.@.@.@
..@@..@@.@..@..@@@@.
.@.@.@@@.@.@..@..@..
...@..@..@.@@@.@.@.@
.@...@.@.........@..
@@@.@....@.@@@.@@..@
@@...@.@.@@@...@.@.@
@.@@.@..@.@.@.@.....
.......@@......@.@.@
@@.@.@@@..@.@.@@@..@
.@..@@..@@@@...@.@..
.@.@@..@@@@@@.@....@
....@@..@@@.....@@@.
.@.@.@.@...@.@@.....
@........@@...@.@.@.
14
6 18 0
10 9 0
15 18 0
2 4 0
10 6 0
13 17 1
0 7 1
1 17 1
17 14 1
13 15 1
16 4 2
10 5 2
16 18 2
10 13 2

16 11 0
2 8 0
18 13 0
19 6 0
15 9 0
16 8 1
11 0 1
18 10 1
9 5 1
19 17 1
15 4 2
4 8 2
7 0 2
10 7 2
