width 20
height 20
@@.@.@@@@@@@@@@@@@@@
@.....@@@@@@@@@@@@@@
@@.@.@.@.@@@@@@@@@@@
@@@.......@@@@@@@@@@
@@@@.@@@@.@@@@@@@@@@
@.@@@@.@@.@@@@@@@@@@
@..@@@....@@@@@@@@..
.@..@..@@....@@@..@.
...@.@..@.@.@.@.@...
.@.....@.@@.....@.@.
@.@.@.@@....@.@....@
.....@@..@.@...@.@..
.@.@.@@@..@@@.@.@.@@
.@@...@@@@.@.@......
.@@@.@.@.......@@.@@
..@@@@...@.@@@.@...@
.@.@.@.@.@@.@.@.@.@@
........@...@......@
.@.@.@.@.@@...@.@.@@
..@..@...@..@@@@....
14
0 9 0
0 11 0
9 7 0
10 19 0
10 11 0
14 9 1
3 1 1
10 10 1
11 19 1
13 10 1
16 17 2
1 11 2
2 12 2
16 11 2

17 13 0
10 10 0
2 7 0
11 18 0
8 19 0
18 10 1
18 19 1
0 17 1
19 11 1
15 8 1
6 15 2
13 16 2
15 13 2
13 17 2
