width 20
height 20
@@@.@@.............@
@@.....@@.@.@.@.@@..
@..@.@.@...@.@.@@..@
.@..@@@.@@.....@.@.@
...@.@..@.@.@.@.....
@.@..@@.@..@.@..@@.@
...@.....@...@@...@@
@.@@@.@@.@.@.@.@.@.@
......@...@@........
@.@.@@@@.@@@.@.@.@.@
@@..@@@@@@@@@..@.@@@
@@.@@@@@@@@@@@.@..@@
...@@@@@@@@@@@.@.@@@
.@..@@@@@@@@@@@..@@@
..@.@@@@@@@@@@@@..@@
@..@@@@@@@@@@@@..@@@
..@@@@@@@@@@@@@@@@@@
@.@@@@@@@@@@@@@@@@@@
@@@@@@@@@@@@@@@@@@@@
@@@@@@@@@@@@@@@@@@@@
14
9 1 0
12 0 0
5 1 0
18 7 0
8 6 0
5 7 1
16 14 1
3 9 1
11 4 1
13 10 1
0 14 2
16 10 2
15 8 2
3 10 2

1 15 0
10 3 0
4 4 0
7 0 0
16 11 0
3 14 1
1 4 1
12 6 1
13 1 1
16 15 1
9 4 2
15 0 2
13 4 2
18 2 2
