width 20
height 20
@.@.@.....@.........
......@@.@.@.@.@.@.@
@.@.@..@......@@@...
..@@.@.@.@@.@.@@@@@.
@.@...@..@.@.@.@@@@.
@@@@.@.@.....@..@...
@......@.@.@...@@@.@
@@.@@@.@..@@.@..@@@@
......@.@@..@@.@.@.@
@@@@.@....@.@.......
..@....@.@..@@@@@.@.
.@.@.@@..@.@.@.@.@..
.......@.......@.@@.
@.@.@.@@.@.@.@......
@..@@.@@@.@@@..@@.@.
..@@.@@@..@@..@....@
@..@.@@.@.@@@..@.@..
@@....@.....@.@.@..@
@@@.@@..@.@......@..
@@@@@@@..@..@.@@.@@@
14
1 12 0
5 13 0
3 8 0
11 3 0
15 13 0
1 2 1
3 10 1
17 13 1
17 10 1
2 7 1
13 6 2
4 11 2
17 2 2
4 10 2

19 2 0
18 13 0
12 4 0
16 13 0
15 7 0
5 1 1
18 0 1
14 0 1
18 15 1
13 19 1
7 9 2
9 15 2
8 3 2
12 5 2
