width 20
height 20
...@.@.@.........@..
.@.....@.@.@.@.@...@
@.@.@@@.@@@.@.@.@@.@
.....@@...@.........
@.@.@@@.@...@.@.@@.@
..@@.@...@.@@@.@@@.@
@......@..@@@@.@@@..
..@.@.@..@@@@...@@.@
@.@@@@@@@@@@@@.@.@..
@...@@@@@@@@@......@
@@.@.@@@@@@@@@.@.@.@
......@@@@@@@@@..@@.
@.@.@.@@@@@@@@@@....
@@.@@..@@@@@@@@@@.@.
@.....@@@@@@@@@@@@..
.@.@.@@@@@@@@@@@@@@.
.@..@.@@@@@@@@@@@@@@
.@.@@.@@@@@@@@@@@@@@
.......@@@@@@@@@@@@@
.@.@@.@@@@@@@@@@@@@@
14
3 1 0
17 3 0
1 2 0
2 18 0
13 7 0
3 6 1
1 4 1
18 0 1
6 13 1
4 1 1
1 3 2
19 8 2
11 0 2
18 1 2

18 6 0
2 11 0
19 14 0
4 15 0
3 4 0
15 3 1
1 2 1
4 6 1
2 15 1
15 11 1
1 11 2
0 15 2
11 0 2
14 10 2
