width 20
height 20
.@@..@@.@@.@.@.@.@..
.@..@@.............@
..@.@@@.@.@@.@.@@@..
.@..@@@@.@@@..@@@..@
..@..@@@..@.@@.@.@..
@...@.@..@.........@
..@.....@.@.@@.@.@.@
@..@.@@.......@..@@@
@@@.@...@.@@.@.@@..@
@@@..@.@.@.@.@.@..@.
@@@@........@....@..
@@...@.@.@@@..@.@@@.
@@@@.@@@..@.@..@@@@.
@@.@.@.@@@....@.@@..
@.........@.@....@@.
@@.@@@.@@..@.@@.@.@.
@.@...@...@..@......
...@.@.@.@.@...@@.@.
@@...........@...@..
@@@.@@.@.@.@..@.@..@
14
9 10 0
14 9 0
15 16 0
7 1 0
13 7 0
12 17 1
14 14 1
8 1 1
6 18 1
16 7 1
17 8 2
12 19 2
3 0 2
2 7 2

14 17 0
16 5 0
3 6 0
16 14 0
19 11 0
12 16 1
13 12 1
3 11 1
14 5 1
14 9 1
1 4 2
12 18 2
3 2 2
6 8 2
