width 20
height 20
@.@@@......@@@.@@..@
...@..@@@@@.@....@..
@.@.@.@@@.@...@@..@.
............@..@.@@.
.@@@@.@.@@@@..@...@.
@@@..@.@@.@.@..@.@..
.@@@.@.@......@@@..@
.........@@.@...@@.@
.@.@.@@@@@@@@@.@....
.@..@..@.@@.@.@..@.@
@..@..@@........@...
..@.@....@@.@.@@.@@.
@.....@@.@@@@@@@....
.@.@.@@.@@..@@@..@@.
.@..@.....@..@@@@@@.
...@@.@@@...@@@.....
.@...@@@..@@....@.@.
@@@.@.@.@...@.@..@@@
@........@.@@@..@.@.
..@.@@.@....@@@.....
14
5 1 0
4 3 0
0 15 0
1 7 0
13 4 0
17 16 1
16 11 1
13 16 1
2 14 1
6 7 1
19 3 2
1 11 2
6 19 2
8 9 2

15 15 0
16 19 0
17 4 0
4 1 0
10 6 0
0 11 1
19 14 1
0 15 1
18 15 1
13 3 1
18 5 2
17 12 2
4 6 2
19 19 2
