width 20
height 20
.@@@.@@..@@@.....@@@
.@@...@.@.@@@.@.@@@@
...@.@@....@...@@@@@
.@@.....@.@.@.@..@@@
.@.@.@.@........@.@.
...@..@@@.@.@.@.....
@.@..@.@@@@@...@@.@.
....@@.@@.@.@@..@.@.
@.@@.@..@...@.@@.@..
@@@....@@.@.......@.
@.@.@@.....@.@.@.@..
@...@@@.@.@@@@@....@
..@@.@.@.@@@.@@@@.@@
@......@..@..@.@.@@.
@@.@@@.@.@.@........
@...@........@.@.@.@
@@@..@.@.@.@.@..@...
@...@...@@@.@.@@@@.@
.@.@@@.@........@...
.....@...@.@.@@@@@.@
14
18 15 0
4 1 0
8 19 0
0 2 0
7 19 0
1 5 1
17 5 1
15 1 1
10 16 1
5 5 1
14 16 2
9 7 2
10 15 2
1 12 2

6 8 0
11 7 0
3 11 0
4 5 0
1 7 0
3 13 1
19 4 1
19 6 1
8 13 1
1 5 1
5 9 2
7 17 2
4 4 2
2 14 2
