width 20
height 20
@@@@.@.@.@...@..@..@
@@@........@@.@...@@
@@.@@.@.@.@@@.@.@.@@
@.....@@..@@...@...@
@@.@@.@@@@@.@.@.@.@.
@@...@@@@@..........
@..@@@@@@@@@@.@@.@@.
.@.@@@@@.@@..@@@@...
...@.@.@....@@@@.@.@
.@.....@.@.@@@@@....
@..@.@....@@..@@.@@.
.@..@..@@....@...@.@
...@@@.@@.@.@.@@.@..
.@@.@.@@@@.......@.@
.......@@.@.@@.@....
@.@.@.@....@.@@..@@@
..@@.@.@.@.@.@.@....
@..@.@...@.......@.@
@.@@...@..@.@.@.@..@
@..@@.@..@...@..@@..
14
10 17 0
18 12 0
0 12 0
19 14 0
8 8 0
14 19 1
15 2 1
19 16 1
2 14 1
14 5 1
2 8 2
11 19 2
2 17 2
18 18 2

13 4 0
1 10 0
14 0 0
16 3 0
4 16 0
14 17 1
5 1 1
12 16 1
16 13 1
5 18 1
2 11 2
1 16 2
7 2 2
13 10 2
