width 20
height 20
@@@@.@...@@@@@@@.@.@
@@.....@..@@@.......
@@@@.@.@@..@.@.@.@.@
@@@...@..@@...@@@...
@@@@.@.@.@.@.@.@.@.@
@.@.................
@.@@.@.@.@.@.@.@@.@@
....@@@.@@@@.@...@@@
@@.@.@...@...@@.@@@@
@@.@.@@.@@@@.@@@@@@@
@@...@..@@@@.@@@@.@@
...@...@@@@...@@@.@@
.@@.@@@.@@.@.@.@...@
.................@@.
@.@.@@.@@@.@.@.@....
@@...@..@@@...@..@.@
...@@@.@@@.@.@@@@...
@.@.....@......@.@.@
...@.@.@@.@@.@....@@
@.@...@....@@..@.@@@
14
8 13 0
2 1 0
5 13 0
10 6 0
18 17 0
8 3 1
1 16 1
6 1 1
7 15 1
6 14 1
14 7 2
9 1 2
13 5 2
9 19 2

7 19 0
12 12 0
14 7 0
14 13 0
16 14 0
6 10 1
4 15 1
7 10 1
7 15 1
8 6 1
12 3 2
13 15 2
12 13 2
12 14 2
