width 20
height 20
...@.....@....@@@@@@
@@...@@.@.@.@.@.@@@@
@.@.@@.......@@...@@
...@@..@@@.@@@@@.@.@
@.@@@@.@.@..........
...@@....@@@.@.@@.@@
.@@..@.@.@@@@@@.@...
....@.@@@.@@.@@...@.
@.@.............@.@.
...@.@@.@@.@.@.@.@@@
@.@@...@@.@.@.@@..@.
....@.@.@.@...@..@..
@@.@....@...@.@.@.@.
...@@.@..@@..@@.....
@.@@@@..@.@.@.@.@@.@
@@@@@@@...........@@
@@@@@@@@.@@@.@.@.@..
@@@@@@@@@.....@..@.@
@@@@@@@@@@.@.@@@....
@@@@@@@@@@.@....@.@@
14
4 0 0
16 13 0
6 0 0
10 17 0
5 10 0
17 10 1
11 15 1
19 11 1
12 18 1
1 3 1
15 19 2
12 13 2
5 0 2
5 5 2

7 13 0
15 13 0
17 8 0
1 5 0
1 14 0
13 14 1
5 0 1
7 5 1
6 10 1
13 0 1
4 9 2
17 7 2
19 11 2
2 0 2
