width 20
height 20
@@@@@@.@@@....@.@..@
@.@@@...@.@@@....@..
.....@.@@..@@@@.@.@.
.@.@.@.@.@..........
@@@........@.@@.@.@.
.@.@.@.@.@.@@..@.@..
.....@..@...@@.@.@@.
.@.@.@.@@@.@@.......
@...@@@@@@@...@@.@@.
.@.@@@@@@@@.@...@@..
.....@@@@@.@..@@@@@.
.@@.@@.@@@.@@.@@@.@.
..@.@...@...@..@..@.
.@.@.@.@.@.@.@@.@.@@
....................
.@@@@.@.@@.@@.@@@.@.
..@@@.@..@@...@.@@.@
.@.@@@@.@...@.......
.@...@.@.@.@@@@.@.@.
.@.@........@@@@..@.
14
5 15 0
6 7 0
17 15 0
11 9 0
16 7 0
12 8 1
6 18 1
8 14 1
15 17 1
7 19 1
19 1 2
13 3 2
2 7 2
18 0 2

14 3 0
5 4 0
10 0 0
15 7 0
3 10 0
7 19 1
12 8 1
13 14 1
15 17 1
4 13 1
14 7 2
6 12 2
6 14 2
13 17 2
