width 20
height 20
@@@@@@.@....@.@.@.@.
@@@@@....@.@@.......
@@@@@.@@@.@...@.@.@.
@@@@........@@@@@@..
@@@@@.@.@.@..@@.@.@.
@@@@.@...@..@.@.....
@@@....@..@...@@.@@.
@@@@.@@..@@.@...@@..
@@@@@@..@@@@..@.@..@
@@@@@@@..@@.@..@.@..
@@@@@@@.@.....@..@@@
@@@@@@..@@.@.@..@.@@
@@@@@@@@@...@@@....@
@@@@@@@@@@.@@@.@@.@@
@@@@@.@.@@.@........
@@@@.........@.@.@.@
.@@.@.@@.@.@@@@.@@..
......@@.@@........@
.@.@.@@@@@.@.@.@.@..
..@....@......@...@@
14
10 13 0
7 5 0
2 18 0
7 1 0
11 15 0
18 12 1
9 4 1
16 5 1
14 9 1
7 11 1
5 19 2
4 18 2
19 16 2
5 15 2

15 12 0
2 17 0
7 15 0
19 14 0
4 18 0
5 3 1
8 19 1
17 19 1
8 16 1
16 14 1
18 7 2
7 14 2
17 17 2
15 19 2
