width 20
height 20
@@@..@@.@...@@@@....
@@..@....@.@.@@.@@.@
@@@...@.@...........
@@@@@..@.@.@.@.@.@.@
@.....@..@@.@...@..@
.@@.@.@.@.@.@.@..@..
..@@..........@.@@@@
.@@@.@.@.@.@@..@.@..
..@...@.@.@@@.@....@
@.@@@......@@@@@@@..
......@.@.@.@.@..@.@
.@.@@..@....@...@...
..@@..@@@.@...@@.@.@
.@..@..@@@..@.......
..@.@.@.@.@..@@.@.@.
.@..@.....@.@...@..@
@.@.@.@.@.@@.@@@@.@.
..@..@..@@.@.@.@@...
@.@.@.@.@.........@.
.........@.@@@.@.@..
14
11 12 0
10 3 0
16 18 0
3 1 0
14 11 0
16 3 1
16 5 1
7 17 1
10 11 1
3 17 1
12 18 2
9 18 2
7 1 2
16 0 2

7 0 0
6 7 0
5 2 0
18 7 0
9 15 0
7 5 1
17 8 1
12 14 1
13 10 1
19 16 1
8 6 2
5 5 2
5 1 2
0 15 2
