width 20
height 20
@..@.@@.@@........@@
@@.@.......@.@.@.@@@
@@..@@@.@.@@@@@...@@
@.@......@.@.@.@@@.@
....@.@.@...........
@.@@@.@@.@.@.@@.@.@.
...@.@.@.@@@@@.@.@@.
@.@@................
.....@.@@.@.@.@.@.@.
.@.@@..@@@@@...@@@..
..@.@@......@@@...@@
.@...@.@@@.@.@.@@..@
..@.@.@@.@.......@..
.@@........@.@.@...@
@@@@.@.@@.@.@@@..@.@
@@@@..@.@.@.....@...
.@@@.@....@.@.@..@.@
..@@@@@.@.@@...@@@@@
.@.@.@...@.@@.@.@@@@
.......@....@....@@@
14
12 13 0
9 17 0
4 6 0
10 19 0
19 12 0
14 15 1
3 3 1
5 13 1
0 11 1
13 15 1
2 4 2
14 9 2
14 3 2
18 16 2

12 3 0
12 5 0
10 13 0
9 13 0
9 4 0
4 14 1
6 9 1
15 0 1
0 11 1
14 1 1
16 16 2
15 5 2
7 13 2
12 15 2
