width 20
height 20
...@@....@.....@.@.@
.@....@.@@@.@@@.....
..@.@..@@@...@@@.@.@
.@.@..@....@..@...@@
...@.@@@.@.@.@@@.@@@
@@..@.@.@@@...@...@@
..@......@.@.@.@.@.@
.@.@@.@.@..........@
.......@@@.@@.@.@.@@
.@.@.@.@@@.@.@...@@@
..@@@@..@....@@@@@@@
.@.@...@@@.@...@.@.@
...@@.@...@..@......
.@.@@..@.@.@..@@@.@@
@@..@.@..@...@@.@@@@
.@.@.@@.@.@.@@...@@@
..........@....@..@@
.@@.@.@.@...@.@@.@.@
...@@@.@@.@.@@......
.@......@@@@...@.@.@
14
6 9 0
17 7 0
4 1 0
0 3 0
16 15 0
8 16 1
3 1 1
13 19 1
13 16 1
15 12 1
8 0 2
16 4 2
18 11 2
7 19 2

7 19 0
0 13 0
3 6 0
16 12 0
0 18 0
14 7 1
10 4 1
0 3 1
7 17 1
0 0 1
17 12 2
5 0 2
11 16 2
2 16 2
