width 20
height 20
@...@@..@...@@@@@.@@
..@@.@@..@.@@@@@@...
@.....@@....@@@@..@.
.@.@@....@.@.@.@.@.@
.@.@@@.@.@..........
.@..@..@.@.@.@.@.@@.
...@.@..@@@@@@@.@.@.
@.@....@@@@@.@......
@@@@.@@@@@.@.@.@.@.@
@@@@@...@.......@@@.
.@.@.@.@@@.@.@.@.@..
........@...@......@
.@@@@.@@.@.@.@.@.@.@
.@.@.@.@...@...@..@.
.........@.@@.@.@...
@.@@.@.@.@@.@@...@@.
....@.@.@.@.@.@.@...
@.@..............@@.
...@.@@@.@.@.@.@@@@.
.@@@@@@@@@@...@@@@..
14
10 10 0
13 4 0
6 3 0
4 11 0
4 14 0
9 9 1
4 8 1
5 11 1
7 9 1
10 12 1
3 14 2
19 16 2
3 2 2
11 0 2

19 5 0
14 4 0
12 19 0
18 10 0
1 2 0
11 16 1
2 13 1
6 3 1
1 6 1
2 2 1
14 7 2
1 7 2
12 13 2
10 0 2
