width 20
height 20
@.@.@@..@@@..@..@@@.
....@..@.@.@..@..@..
@.@..@.@....@...@@@.
..@.@@...@.@.@.@.@@.
@.@..@@.@@..........
@@..@@..@@@.@.@.@.@.
@.@.@.@.@...@..@@@..
.......@@.@..@..@@@.
.@@.@.@@.@..@.@@@@@.
...@......@.@.@@@@..
.@@.@.@.@..@..@@@..@
..@...@.@.@..@.@.@.@
.@.@@..@@@.@........
...@.@@@@@...@.@.@.@
@@....@@.@@.@@@@@...
@.@@.@....@@@@@@.@.@
@......@.@@@........
..@.@@@.@.@@.@.@.@.@
.@.@.@........@..@.@
.......@.@.@.@@@..@@
14
12 12 0
19 5 0
14 2 0
2 7 0
19 2 0
19 7 1
5 1 1
5 12 1
11 4 1
8 3 1
19 9 2
19 1 2
16 11 2
0 17 2

19 7 0
9 11 0
3 19 0
6 15 0
4 18 0
0 3 1
7 18 1
13 4 1
7 9 1
4 16 1
2 7 2
12 18 2
11 11 2
16 18 2
