width 20
height 20
@@@....@..@.@.@.@..@
.@.@@.@.@.@.@.@.@.@@
...................@
.@@.@.@.@.@@.@.@.@.@
@@.@...@..@.@..@.@..
@...@@@@@.@..@.@@@@.
@@.@.@.@....@.@..@.@
@....@.@@.@....@....
.@.@...@.@.@@.@@.@.@
..@..@.....@@.@.@...
@.@@..@.@@......@@@.
...@.@@@@..@.@@..@..
@.@.@.@.@@.@@@@.@.@.
............@@@...@.
@.@.@@.@.@.@@@@.@...
@..@....@@@@@@@@..@.
..@..@.@@@.@@@@..@..
@..@.@.....@@@@@.@.@
..@@@..@@.@.@@....@@
@.@@@@..@.....@.@.@@
14
9 2 0
12 3 0
3 13 0
4 13 0
1 5 0
18 2 1
0 8 1
4 2 1
15 10 1
14 3 1
9 13 2
6 4 2
1 19 2
12 7 2

6 6 0
17 2 0
5 2 0
19 5 0
2 6 0
7 9 1
9 9 1
3 3 1
7 1 1
14 3 1
0 1 2
1 2 2
16 17 2
0 2 2
