width 20
height 20
.@.@.@.@@@@@..@@@@@@
.......@@.@.@..@@@@@
@@@@.@........@..@@@
@.@.@.@@@.@.@@.@..@@
@........@..@....@@@
..@.@.@.@@@...@.@.@@
@..@@@.@.@.@.@@.....
@.@.@.......@@..@@.@
@....@.@.@.@..@..@.@
.@.@...@@@..@...@@@@
...@.@.@@..@.@@...@@
.@..@@@..@......@...
..@@.@.@.@@@.@.@..@@
@..@........@@@.@@@@
@@.@.@@.@.@.@.@.@@@@
@..@.@@@..@......@.@
.@....@.@..@.@.@....
...@@@..@.@@@@@..@.@
@.@.@@.@@@@@....@...
.........@@@@@@..@.@
14
6 17 0
17 18 0
14 12 0
1 6 0
5 19 0
18 11 1
7 13 1
1 5 1
4 4 1
6 7 1
8 6 2
14 11 2
15 10 2
10 2 2

6 6 0
7 14 0
14 11 0
0 5 0
13 15 0
15 13 1
2 1 1
14 1 1
10 7 1
17 5 1
8 7 2
16 16 2
1 17 2
12 5 2
