width 20
height 20
@...@..@@@......@...
..@@@@.@@@.@.@.@@@.@
@...@...@...@@..@...
..@.@.@..@@.@..@.@.@
@..@.@..@..@.@......
@@...@@..@.....@.@.@
@.@@..@.@..@.@@@@.@.
.....@....@@@.@...@.
@.@.@.@.@.......@...
@@......@@.@.@@.@.@.
@..@.@@..@@@.@@@@@..
@@..@.@@....@.@.@.@.
@@.@...@.@@@........
@...@.@.@.@.@.@.@.@.
@@.@...........@.@.@
@@@.@.@.@@@.@.@@....
@@@...@@.@.@.@.@.@.@
....@@............@@
@.@....@.@.@.@.@.@@@
@@..@@..@...@@@..@@@
14
10 0 0
16 3 0
17 15 0
15 11 0
17 7 0
3 5 1
14 0 1
12 8 1
2 0 1
5 16 1
17 9 2
0 3 2
1 7 2
17 0 2

12 6 0
11 13 0
14 17 0
10 16 0
12 10 0
4 6 1
1 18 1
3 16 1
15 13 1
10 8 1
17 8 2
12 9 2
3 8 2
19 6 2
