width 20
height 20
....@.@@@......@.@.@
@.@.@..@..@.@.@@.@..
...@.@...@@@.....@.@
@@....@@..@.@.@@....
...@@@.@.@..@@.@.@@@
.@.@.......@....@.@.
@@.@@.@@.@..@.@.....
@...@.@.@.@...@.@.@.
.@.@.@@....@@.@..@..
.......@.@@.@@.@@..@
.@.@.@...@.....@.@..
..@@@..@.@.@.@.....@
.@@..@..@...@..@.@..
....@@@@.@.@@.@...@.
.@@..@.@...@...@.@.@
@.@.@....@..@.@@@...
......@.@..@.@.@.@@.
@.@.@..@.@..........
@.@..@...@.@.@@.@.@.
..@.@@.@.@.@...@...@
14
3 19 0
13 17 0
5 11 0
2 6 0
2 10 0
1 19 1
14 0 1
0 11 1
15 8 1
3 7 1
15 17 2
2 13 2
2 3 2
14 14 2

10 6 0
8 8 0
8 5 0
15 17 0
3 13 0
19 8 1
13 6 1
8 17 1
13 1 1
19 7 1
5 15 2
8 1 2
11 7 2
16 17 2
