width 20
height 20
@..@@@@@@.@@.@.@.@..
@.@.@@@@...@.@.....@
......@.@.@..@.@.@..
@.@.@.....@.@.@.@..@
...@@.@@@........@..
@.@@.@.@..@@.@@@.@.@
@@...@..@..@@.......
@@.@...@@.@.@@.@.@.@
@.@.@.@.@...@...@@.@
..........@..@.@@@@.
.@.@.@.@.@..@.@@@@..
@..@@.@...@.@..@@@.@
@@....@@.@.@.@..@...
@@@.@..@.....@.@.@.@
@@@@..@..@.@........
@@@@@@.@..@..@.@@.@@
@@.......@@.@...@@@@
...@.@.@...@.@.@.@@@
.@..@...@.@@...@.@@@
@@.@@@.@....@@....@@
14
9 13 0
6 18 0
12 13 0
16 6 0
10 13 0
2 2 1
8 5 1
11 15 1
13 16 1
14 1 1
18 14 2
7 14 2
18 2 2
16 18 2

7 9 0
8 10 0
15 19 0
14 7 0
6 13 0
9 11 1
9 5 1
6 5 1
13 8 1
5 8 1
14 17 2
1 11 2
19 0 2
18 7 2
