width 20
height 20
......@@@...@.......
@.@@.@@@..@...@.@@.@
@@.@..@.@.@.@@@@....
.....@.....@@@@@@.@.
.@.@@..@.@.@@@@@...@
.@.@.@.@@@@@@.@.@@.@
.@.....@.@.@....@.@.
..@@.@.@.....@@.....
.@@...@..@.@.@.@@@.@
.@@@.@.@..@@@...@...
@.@@.@...@.@.@.@.@.@
.......@.@.@........
.@@.@.@....@.@.@.@@.
@.@..@@@@.@@.@.@.@..
@.@.@.....@.@.@.@.@.
....@@.@.@@.........
.@.@....@...@.@.@.@.
..@@@@.@@@.@...@@@@.
.@.@......@@@.@@@@..
@....@.@@..@...@@@@.
14
12 11 0
0 16 0
1 14 0
16 4 0
19 6 0
2 2 1
9 2 1
5 16 1
6 16 1
9 7 1
17 6 2
2 5 2
19 7 2
6 9 2

18 0 0
8 7 0
14 19 0
5 8 0
7 8 0
1 15 1
10 19 1
16 12 1
19 3 1
9 16 1
4 11 2
4 6 2
16 7 2
2 0 2
