width 20
height 20
@.@..@...@@.....@@@.
....@..@....@@@.....
@.@..@.@@.@.@@@@.@.@
.@..@..@.@..@@@.@.@@
..@.@@....@.........
@....@.@.@.@@.@.@@@.
..@.@@.@.....@@.@@..
@..@@@@..@.@@..@.@@.
@@..@@..@..@.@......
@@.@..@@@.@@...@@.@.
@...@..@.@.@.@@....@
@@@..@.......@..@.@@
@..@...@@@.@@@@.@.@@
@.@@.@...@@@.@.@.@@@
...@@@@.@.@........@
@.@.@.@...@.@.@.@.@@
........@.@..@@.@@@@
@.@@.@.@....@@@@@@@@
@.@...@@@.@.@@@@@@@@
@.@@.@@@@@..@@@@@@@@
14
5 12 0
5 18 0
7 4 0
8 1 0
11 16 0
3 16 1
0 16 1
19 6 1
15 11 1
2 7 1
14 9 2
7 15 2
13 4 2
15 1 2

8 10 0
17 12 0
12 9 0
1 1 0
7 11 0
15 6 1
17 1 1
19 4 1
12 0 1
17 11 1
4 9 2
9 8 2
15 3 2
10 11 2
