width 20
height 20
@@@@@@@@@@.....@.@@.
@@@@@@@@@..@.@......
@@@@@@@@@@@@@.@@.@@.
@@@@@@.@@..@@......@
@@..@.....@@@.@.@@..
...@.@@@@..@..@@@.@@
.@.....@..@@@..@...@
..@.@.@.@.@@.@.@@.@@
.@@@...............@
..@.@.@@.@.@.@@.@.@.
.@..@@..@.@.@@.@@...
@@.@.@.@..........@.
.........@@@.@.@.@..
.@.@.@.@...@.@@...@@
..@...@@@@@@...@.@.@
.@@@.@@@@@@@@.@.....
..@@@@@@@@@@.@.@.@.@
@..@@@@@@@@@....@...
@@..@@@@@@@@@@@.@@.@
@..@@@@@@@@@@@@....@
14
14 10 0
5 14 0
12 14 0
1 12 0
4 13 0
14 3 1
1 16 1
10 5 1
15 17 1
18 18 1
14 16 2
16 6 2
13 3 2
5 4 2

9 10 0
19 10 0
4 12 0
3 4 0
12 0 0
7 7 1
11 11 1
12 17 1
3 6 1
14 17 1
14 0 2
18 1 2
1 12 2
10 5 2
