width 20
height 20
@@@@@@@@@@@@@@@@@@@@
@@@@@@@@@@@@@@@@@@@@
@@@@@..@@@@@@@@@@@@.
@@@@@.@..@@@@@@@@@..
@@@@....@@@@@@@@@@@.
@@@@@.@..@@@@@@@@@@.
.@@@@@..@.@.@@@@.@..
......@..........@@.
@.@.@..@.@@.@.@@.@..
.@...@...@...@@@..@.
.@.@.@@@.@@@...@.@..
..@..@.@@.@..@@....@
.@@@.......@.@@@.@..
.@@@@.@@.@@.@.@.@..@
....@@...........@..
.@.@@@.@.@.@.@.@@..@
..@@@..@@...@@@@.@.@
.@.@.@.@.@.@..@....@
.......@...@.@@@.@..
.@.@@@@@@@......@..@
14
4 7 0
19 8 0
5 7 0
8 17 0
13 13 0
0 19 1
1 18 1
2 7 1
6 15 1
7 14 1
16 8 2
0 15 2
12 15 2
0 16 2

4 7 0
16 17 0
2 7 0
5 16 0
16 14 0
16 18 1
12 15 1
13 8 1
18 3 1
13 13 1
1 14 2
6 9 2
14 14 2
17 13 2
