width 20
height 20
@..@.@...@@@@@..@...
..@@..@.@.@@@..@.@@.
@...@.....@.@@.@....
..@...@.@@@..@...@.@
@@..@@.@.@..@.@@..@@
...@.@....@......@.@
@.@....@.@.@@@.@....
@..@.@@@.....@@@@.@.
..@@@@@@.@.@...@@@..
@.@@.@@.@@@@@.@@@@@.
.....@..@.....@.@@..
@@.@...@@.@.@.@.@.@.
.@@.@.@.@..@.@......
..........@@.@.@@.@.
.@.@.@@@@......@@@..
..@..@.@..@.@@..@@@.
.@.@@...@@.@...@.@.@
......@.@@...@.....@
.@.@.@.@@@@.@@.@.@@.
..@.....@@@.@@@.....
14
6 10 0
14 1 0
19 18 0
13 4 0
19 11 0
5 2 1
16 3 1
14 13 1
13 8 1
0 3 1
3 12 2
7 3 2
1 3 2
4 11 2

18 19 0
13 11 0
15 5 0
17 7 0
2 17 0
1 3 1
19 13 1
1 7 1
12 14 1
3 17 1
0 10 2
12 5 2
2 18 2
16 3 2
