width 20
height 20
@@@@@@@@@@@..@.@.@..
@@@@@@@@@...@@....@.
@@@@@@@.@@.@@@@.@...
.@@..@...@.@@@@@@.@@
..@@.@@.@..@@@@.....
@.@...@.@.@.@@.@.@@.
@..@.@.......@....@@
@.@...@.@@@.@..@.@@.
....@.@.@@@...@.@@..
.@.@@@...@@@@.@...@.
..@.@.@@.@.....@@...
@.......@.@@@@....@.
..@.@.@........@@@..
.@.@@@.@@.@.@.@@@@@.
@@.@.@.....@@.@@@@@@
.....@@.@.@.@@.@@@@@
.@.@..@.@.......@@@@
.@@@@.@..@.@.@.@@@@@
...@....@.@.@..@@@@@
.@..@@.@......@@@@@@
14
1 8 0
8 17 0
5 5 0
4 14 0
4 5 0
2 18 1
16 1 1
1 12 1
8 14 1
0 12 1
13 18 2
3 12 2
8 3 2
3 11 2

3 11 0
5 16 0
4 18 0
13 12 0
0 4 0
15 8 1
0 19 1
17 3 1
13 13 1
0 10 1
11 15 2
14 10 2
6 6 2
2 19 2
