width 20
height 20
@@@@@@@@@@@@@@..@@@@
@@@@@@@@@@@@@..@@@@@
@@@@@@@@.@.@.@..@@@@
@@@@@@@........@.@@@
@@@@@@@@@@.@.@@@.@@@
@@@@@@@@....@@....@@
@@@@@@@..@@.@..@@@..
@@@@@@.@.@.@.@.....@
@@@@@..........@.@..
@@@...@@.@.@@.@.@@.@
@@@@@...@.@..@@.....
@@@@..@.....@@@.@.@.
@.@.@@..@@@@....@@..
.......@....@.@..@@.
@.@.@.@@@.@..@.@.@@@
...@@...@@.@...@@@@.
@.@@..@.....@@...@..
@@@@@@..@@.@@.@@.@@.
@@@@@@@.@...........
@@@@@@...@.@.@.@@.@.
14
19 11 0
15 9 0
1 15 0
13 8 0
8 6 0
8 3 1
8 5 1
15 13 1
16 17 1
10 11 1
19 17 2
6 13 2
9 13 2
17 5 2

1 12 0
19 16 0
11 6 0
9 13 0
9 5 0
18 7 1
15 0 1
18 18 1
14 8 1
9 10 1
10 3 2
13 3 2
10 8 2
19 19 2
