width 20
height 20
@@@@.@.@@@@@.@.@...@
@@@.......@.....@.@@
@@..@.@@.@.@.@.@@...
@@@..@..@....@.@.@.@
@@..@.@...@.@....@..
@@@.....@.@@.@@@...@
@.@.@.@.@....@@@.@.@
...@...@@@.@@.@..@..
.@..@.@....@...@.@.@
@.@..@..@.@.@.@.@...
@...@@@..@.......@.@
@.@@....@@@.@.@@....
....@.@..@...@@.@.@.
.@@...@@@.@.@.....@.
@@@@@.@......@@@.@.@
@@@.@@..@.@.@@.@@...
@@.....@.@@@.@.@.@.@
...@.@..............
.@..@@@.@.@@.@.@.@.@
..@@@@@..@@...@..@@@
14
18 0 0
3 6 0
12 8 0
18 11 0
5 13 0
14 15 1
11 4 1
18 10 1
5 16 1
18 16 1
8 8 2
7 3 2
11 15 2
2 4 2

14 8 0
12 12 0
3 12 0
16 6 0
7 15 0
8 2 1
19 15 1
0 12 1
4 11 1
3 10 1
5 5 2
7 10 2
2 12 2
15 4 2
