width 20
height 20
@@@@.@.@.@@@@.@@@.@.
@@@............@....
@@@@.@.@@.@.@.@@@.@@
.....@.@@..@....@...
@.@.@.@.@.@.@@@...@.
...@..........@.@.@@
@.@@@.@.@@@.@..@@...
..@@@@.@...@@@..@.@@
.@.@@..@.@.....@@..@
.@....@@@..@.@..@.@@
@.@@@..@@@..@@@@.@@@
..@.@.@@.@.@@@@...@.
@.....@.....@.@.@.@.
.@@.@@..@.@...@@....
.......@@@@.@.@.@.@.
.@.@.@.....@.......@
..@@@..@.@@@@.@@@.@.
.@.@.@@...@@@@......
.....@@@.@.@..@.@.@.
.@.@..@......@...@@.
14
17 16 0
19 16 0
0 18 0
12 9 0
15 9 0
2 14 1
18 13 1
17 14 1
17 17 1
7 6 1
6 7 2
17 1 2
0 14 2
15 4 2

0 7 0
6 14 0
8 0 0
2 5 0
14 7 0
3 4 1
19 3 1
7 15 1
13 6 1
18 8 1
10 1 2
0 8 2
1 5 2
15 17 2
