width 20
height 20
@@@......@@@@@@@@.@.
@@@@@.@.@.@.@.@@....
@@@@@.@........@@.@.
@@@@.@.@.@.@.@.@.@..
@@@......@..@.....@.
@@..@.@.@@@@.@.@.@@.
@.@..@@@........@...
..@.@@@@.@.@@@@.@.@.
@.@..@@@@.@.@@.@...@
....@.@..........@..
.@@.....@.@@.@@.@..@
...@@@.@@.@@@..@.@..
.@@.@.@.@@.@.@.@...@
.@...............@..
@@@.@@.@@.@.@.@.@..@
@@..@.@@@@@@@..@@@..
@@@....@@.@...@@@@@.
@@@@@.@.@.@.@..@@@..
@@@@......@.@@.@@.@.
@@@@@.@.@@@@...@....
14
9 10 0
11 4 0
2 13 0
18 10 0
8 7 0
16 1 1
1 9 1
12 2 1
17 4 1
5 19 1
16 19 2
2 11 2
19 11 2
18 3 2

8 4 0
18 14 0
13 4 0
11 4 0
11 8 0
10 12 1
9 13 1
15 9 1
16 4 1
15 7 1
11 13 2
2 13 2
19 13 2
7 10 2
