width 20
height 20
@@@@@@@@@@@@@@@@@@@@
@@@@@@@@@@@@@@@@@@@@
@@@@@@@@@@@@@@@@@@@@
.@@@@@@@@@@@@@@@@@@@
.@@@@@@@@@@@@@@@@@@@
..@@@@@@@@@@@@@@@@@@
.@.@@@@@@@@@@@@@@@.@
.......@.@@@@@@@@...
@.@.@@...@@@@@.@@@.@
...@@@.@@@@@@...@@..
@.@@@....@@@@@.@.@.@
.@.@.@.@@.@.@.......
.@.....@......@.@.@@
...@@.@@@.@@@..@..@.
.@@.@@@@...@@.@..@..
....@.@.@@..@@.@@.@.
@.@........@@.......
...@.@.@.@....@@@.@.
@.@@@...@@.@.@@.@@..
..@@@@.@@..@.....@@.
14
19 18 0
18 9 0
0 6 0
4 11 0
6 18 0
0 19 1
18 7 1
13 19 1
14 16 1
8 17 1
6 19 2
6 16 2
2 13 2
0 11 2

19 14 0
1 7 0
9 16 0
1 16 0
11 17 0
0 19 1
2 6 1
2 12 1
6 10 1
8 10 1
9 14 2
10 17 2
3 14 2
0 7 2
