width 20
height 20
@@@@@@@@@@..........
@@@@@@@@.@@@.@.@.@.@
@@@@@@@@..@@..@@@...
@@@@.@@..@@@.@.@..@.
@@@@...@..@.@@..@@..
@@@.@@.@@.....@.@.@.
@@..@...@.@.@.......
..@..@.@.@@@@.@.@@@.
.@.@......@..@@@@@@.
.....@@@.@@@..@.@...
@.@@..@@@.@.@.@...@.
@@.@.@@@........@@.@
.@......@.@.@.@.....
...@@@@@@..@@@@.@.@@
.@..@.@.@.@.@.@@....
..@@..........@@@.@.
.@.@@.@.@.@.@@.@.@..
......@..@@..@...@.@
.@.@@.@.@@..@..@....
.@...@...@.@@@.@.@.@
14
18 4 0
13 12 0
8 11 0
18 11 0
0 17 0
18 17 1
2 16 1
16 16 1
10 5 1
16 6 1
11 10 2
14 17 2
0 9 2
13 7 2

9 15 0
9 4 0
9 13 0
17 9 0
2 12 0
19 15 1
7 16 1
15 17 1
7 8 1
3 19 1
1 10 2
14 6 2
16 0 2
18 2 2
