width 20
height 20
....@.@.@.@.@.@@@@@@
@.@@..........@@@@@@
...@.@.@.@@.@..@@@@@
@.@.@@..@.@.@.@.@@@@
....@.@....@.....@@@
@.@....@@.@.@.@.@@@.
.@..@.@@@@..@@...@..
...@...@@.@...@.@.@.
@@..@.@@....@.......
@..@..@.@.@@@@.@.@@.
@@.@@.....@.@@@.@.@.
@...@.@.@....@......
..@@.@@@..@.@.@.@.@.
@..@.@.@@.@@@....@..
..@@........@.@.@@@.
.@@@@.@.@@.@@..@@@@.
...@@..@...@.@@@@...
.@@@@@@..@...@@@@@.@
..@@@@@@.@@.@@@@@@@@
.@@@@@@....@@@@@@@@@
14
14 2 0
1 11 0
15 5 0
3 5 0
11 3 0
19 11 1
19 9 1
0 7 1
11 5 1
9 12 1
9 0 2
10 11 2
4 1 2
17 8 2

17 12 0
4 7 0
14 11 0
15 13 0
6 1 0
1 12 1
13 12 1
2 9 1
7 19 1
8 2 1
7 4 2
3 8 2
11 11 2
10 8 2
