width 20
height 20
..@@@@@@@@@@@.@@@.@.
.@.@@@@@@@@@...@....
...@@@@@@@@.@.@.@.@.
@@..@@@@@@@.......@@
@@@..@@@@@..@@.@.@..
..@.@@@@@@@.@.@@.@@.
@....@@@@@@.@.......
..@.@@@@@@...@.@@.@.
@.@@@@@@@.@.@@@....@
...@@@@@.....@..@.@@
@@.@.@.@.@.@.@@.@@@@
@.........@...@.@.@.
..@@.@.@@@.@.@....@.
@.@.@@...@....@.@...
@....@@.@..@.@..@.@@
..@.@@.@.@..@@@@..@@
@..@.......@@@@.@..@
.@.@@@.@.@..@@...@..
...@@@@.@@.@.@@@.@.@
.@.@@@........@@....
14
12 9 0
14 14 0
2 11 0
12 10 0
1 15 0
19 2 1
14 6 1
16 17 1
8 15 1
16 15 1
15 16 2
11 15 2
17 6 2
17 0 2

17 12 0
14 12 0
15 12 0
14 17 0
14 14 0
2 2 1
0 0 1
12 14 1
9 8 1
0 1 1
10 17 2
9 11 2
10 13 2
17 0 2
