width 20
height 20
@.@..@.@@.@@@@......
....@@......@..@.@.@
.@.@...@.@.@.@.@@.@@
..@@@.@@@.......@..@
.@...@.@.@.@@.@..@.@
...@.....@.@@@@@....
@.@..@.@@@@@@@@@.@.@
...@..@@...@@@@@..@.
.@.@.@...@@.@@...@..
..@.@.@.@@.....@..@.
.@@........@.@..@@..
....@.@.@@..@@@@@.@.
@@@..@.@@.@.@.......
@...@..@.....@@@.@.@
..@...@@@.@.@@@@@...
@.@.@@@@.@@..@@...@@
.@@..@......@@.@@..@
....@.@@@.@....@.@..
@.@.@......@.@.....@
...@@@@.@.@..@@.@@..
14
10 10 0
2 4 0
19 19 0
4 0 0
18 6 0
18 8 1
0 8 1
3 15 1
12 9 1
7 11 1
5 11 2
0 19 2
17 0 2
7 8 2

2 1 0
3 11 0
9 3 0
19 5 0
13 4 0
1 14 1
16 7 1
2 17 1
13 3 1
18 18 1
16 4 2
6 13 2
18 5 2
19 12 2
