width 20
height 20
@@@.@@.......@@.@..@
@@..@.@.@.@.@.@.@.@.
@.@......@@.........
....@.@.@@@.@.@.@@.@
.@@..@.@@@@@.@..@@@.
@...@..@@......@.@..
@@.@.@....@@.@...@@.
@....@.@@...@..@....
.@.@..@.@@.@..@..@.@
..@.@.....@.@@..@...
.@...@@.@@@..@@.@@.@
.@@.@.......@@..@@@@
.@....@.@.@.@@@..@@@
...@@..@...@@@@.@@@@
.@...@@.@.@.@@@...@@
..@.@@@..@...@@.@@@.
.@@@@@@.@.@.@@......
.@.@.@@......@@.@@.@
@.......@.@.@@.@....
..@.@.@@@@.......@.@
14
7 12 0
14 2 0
19 4 0
4 12 0
6 2 0
6 0 1
17 0 1
10 5 1
3 12 1
14 16 1
15 6 2
17 14 2
0 3 2
18 8 2

14 11 0
1 19 0
7 6 0
9 17 0
11 11 0
11 18 1
16 14 1
8 13 1
7 0 1
4 4 1
10 13 2
14 6 2
15 19 2
7 10 2
