width 20
height 20
....@@@@@@@.@@...@..
@.@.@@@@@.@..@@@...@
.@..@@@@....@.@@@@.@
...@@@@@@.@....@...@
.@.@.@@@@@@@@.@.@.@@
..@...@@@...........
.@@@.@.@.@.@.@@.@.@.
..........@@@.@..@..
.@.@@.@@@..@..@.@@@.
.@.@.@.@.@...@...@@.
@.@........@..@@...@
...@.@@@.@.@.@@@.@..
@@....@.@.@.@.@.@.@.
.@@@.@......@.......
.@.....@.@@...@.@@.@
...@.@.@@..@@.@@@@@@
.@.@@.@.@.@@@@..@@@@
@@.........@@..@@@@@
@..@.@.@.@@@..@@@@@@
@@.@@@@......@@@@@@@
14
3 7 0
10 5 0
7 7 0
7 16 0
0 8 0
0 15 1
4 10 1
17 1 1
6 14 1
18 11 1
9 1 2
9 5 2
6 9 2
12 8 2

17 3 0
13 14 0
5 5 0
15 14 0
16 1 0
4 6 1
10 6 1
8 13 1
0 7 1
1 3 1
17 5 2
19 0 2
5 12 2
13 5 2
