width 20
height 20
.....@@........@.@.@
@@.@..@@@@.@.@......
.@@..@@@@@@@@..@.@.@
.@.@.@@@.@.@.@.@..@@
......@........@.@@@
.@.@.@.@.@.@.@..@@@@
@...@...@...@@@@.@@@
.@.@.@.@.@.@.@.@.@@@
..................@@
.@@.@.@.@@.@@@.@.@.@
...@..@@..@....@....
@.@.@@.@.@.@@@..@.@.
....@......@...@@@@@
@.@@@@.@.@...@@@@@@.
...@@...@@@.@@.@....
@.@@..@@.@.@.....@@.
@@@@@.......@.@.@@@.
@@@@..@.@.@....@.@..
@@@@@@@.@@..@@...@@.
@@@@@@....@.@@.@@...
14
9 12 0
1 11 0
11 10 0
7 16 0
12 4 0
19 11 1
11 14 1
14 3 1
1 13 1
13 4 1
19 17 2
14 10 2
2 0 2
10 5 2

14 3 0
12 10 0
15 16 0
18 10 0
0 4 0
8 15 1
14 4 1
9 10 1
7 17 1
18 14 1
16 8 2
12 8 2
4 1 2
7 8 2
