width 20
height 20
@@...@.@..@..@..@.@@
...@.@...@..@.@.@..@
@@..@..@...@@.....@@
@.@..@.@.@..@.@.@..@
....@.@.@..@@.@@..@.
@.@@.....@.@.@.@@...
..@.@@.@..........@.
@......@.@@@.@@@.@..
..@@.@..@.@.@.@.@.@.
@...@.@@............
..@.@.@@@.@@.@.@@@.@
@.@@.....@@@@.@....@
@@..@@.@@@@@@...@@.@
...@.@..@@@@@@@...@@
@.@....@.@@.@@.@.@.@
...@.@..............
.@....@@.@@.@@.@.@.@
@..@.@.....@.@@@@...
@@..@@.@.@.......@.@
@..@@@@@@..@@.@.@..@
14
17 6 0
18 9 0
16 16 0
5 5 0
6 13 0
10 3 1
9 9 1
18 10 1
5 11 1
4 0 1
12 7 2
6 17 2
16 11 2
18 19 2

10 6 0
7 5 0
1 3 0
9 15 0
12 10 0
15 9 1
12 9 1
11 3 1
9 6 1
14 6 1
17 19 2
8 2 2
19 15 2
18 18 2
