width 20
height 20
@@@@@@@@@@@@@@@@@@@@
@@@@@@@@@@@@@@@@@@@@
@@@..@@@@@.@@@@@@@@@
@@@.@..@@..@@@@@@@@@
@@....@@@@.@@@..@@@.
@@@.@..@.@..@@@.@@..
@.@@.@.....@@.@.@.@.
@.@....@.@........@.
....@.@@@..@@.@.@.@.
.@@.@..@@@@..@@@....
@.@..@@.@@@@.@@.@.@.
@...@.............@@
..@@@@@.@@.@@.@@@.@@
@.@.@@@@.....@.@.@.@
.....@...@.@.......@
@.@.@.@.@..@.@@.@.@@
..@.@.@@.@@.@....@@@
.@.......@....@.@@@@
..@.@.@@..@@.@.@@@@@
.@...@@@.@@.....@@@@
14
8 14 0
14 11 0
9 8 0
1 14 0
17 14 0
2 14 1
12 11 1
6 11 1
14 7 1
0 9 1
3 13 2
9 18 2
16 14 2
8 11 2

5 8 0
1 12 0
4 19 0
5 4 0
11 7 0
9 6 1
18 5 1
1 10 1
9 13 1
16 13 1
4 10 2
15 19 2
0 16 2
13 14 2
