width 20
height 20
@@@@@@@@.@.@@@@@@@@@
@@@@@@@....@@@@@@@@@
@@@@@@@@@@.@@@@@@@@@
@@@@@@@.@..@@@@@@.@@
@@@@@@...@.@@@@@@..@
@@@@@@@@....@@@@..@.
@@@.@@.@.@.@@@@@@...
@@@.......@.@.@@@.@.
.@.@.@.@@@@........@
.....@.@.@@.@.@.@.@@
.@.@..@...@.@@...@@@
..@.@@.@.@@..@@.@@@@
.@..........@...@@@@
.@@.@@.@.@.@@@.@@@@@
....@..@@@@.....@@@@
@.@@.@.....@.@.@@@@@
@@.....@.@@@@@@@@@@@
@.@.@@.@@@@@@@@@@@@@
....@@.@@@@@@@@@@@@@
@.@.@@@@@@@@@@@@@@@@
14
8 5 0
18 4 0
2 12 0
1 18 0
14 13 0
3 14 1
10 1 1
3 11 1
9 15 1
6 8 1
5 7 2
9 7 2
4 10 2
4 15 2

12 14 0
10 3 0
10 0 0
6 14 0
8 1 0
14 8 1
13 12 1
0 12 1
13 8 1
1 15 1
11 14 2
12 8 2
8 10 2
0 10 2
