width 20
height 20
@@.@@.@.@@......@@..
@..@@.@.@.@@.@@.@.@.
..@@..........@.....
.@...@@.@.@@.@@.@.@.
..@.@@@..@..@@@..@..
.@@@.@.@...@@@..@@@@
..@@...@.@@.@.@....@
.@.@.@..@@@.....@.@@
.@...@.@.@@.@.@..@@@
...@@....@..@@..@.@@
@.@...@.@@@..@@....@
@.@@@..@....@..@@.@.
..@@..@..@@..@..@@@.
.@@@@@..@@..@.@.@.@.
..@.@.@@@@@.........
@.....@.@@.@.@.@@.@.
@.@.@.......@..@...@
..@@@@.@.@.@.@@.@.@@
@.@....@@..........@
@.@.@.@@@@.@.@.@.@..
14
8 5 0
4 18 0
15 17 0
12 7 0
11 8 0
8 4 1
17 9 1
11 2 1
7 4 1
5 11 1
6 18 2
11 16 2
0 6 2
6 16 2

0 9 0
19 2 0
10 4 0
8 4 0
1 16 0
13 2 1
15 9 1
15 13 1
1 11 1
13 0 1
6 17 2
13 16 2
5 6 2
3 10 2
