width 20
height 20
@@@@@..@....@@@@@@@@
@@@@..@..@.@.@@@@@@@
@@@@@..@.@....@.@@@@
@@@@.@...@@.@....@@@
@@@@..@@...@@@@.@@@@
@@@@.@@@@@@@@@...@@@
@..@..@@.@@@@.@.@.@.
@@..@.@...@@........
@@@...@@.@.@.@@.@.@.
@@..@@.........@..@.
@..@...@@@@@.@@..@..
..@.@.@.@...@@.@@..@
@.......@.@@@..@.@..
..@.@.@....@@@.....@
@.@@@.@@@.@..@.@@@@@
...@@@......@.......
@.@.@.@.@.@@.@.@.@.@
@@.......@@.....@...
@@@.@.@.@@.@.@.@.@.@
@@@..@..@.....@.....
14
3 11 0
1 11 0
9 19 0
5 7 0
15 7 0
8 13 1
7 11 1
1 6 1
5 14 1
13 2 1
10 15 2
15 4 2
17 6 2
11 19 2

17 7 0
11 0 0
13 19 0
1 13 0
12 2 0
9 11 1
7 11 1
3 8 1
18 12 1
8 4 1
16 16 2
4 6 2
16 3 2
17 11 2
