width 20
height 20
@@@@.@...@...@@@@@@@
@@@....@..@@.@@@@@@@
@@@.@@..@....@@@@@@@
@@@.@.@@.@@.@@@@@@@@
@@.........@@@@@@@@@
@.@@@.@.@.@.@@@@@@@@
.....@@@.....@@@@@@@
.@@.@.@@@@.@@.@@@@@@
@@@.@..........@@@@@
.@@..@.@@@.@.@.@@@@@
.@@.@.@.@.@@..@@@@@@
.............@@@@@@@
@.@@.@.@.@@.@@@@@@@.
@..@..@@@@@@.@@@@@..
@@@..@.@.@.@.@@.@.@.
@..@................
..@@@.@.@.@.@.@@@@.@
@..@@@@..@@@..@@.@.@
@.@.@...@@@.@.@.....
......@..@@....@@@@.
14
10 9 0
5 8 0
4 12 0
3 18 0
4 13 0
17 18 1
13 10 1
7 2 1
19 19 1
12 10 1
4 15 2
2 15 2
14 9 2
8 8 2

13 16 0
10 8 0
10 2 0
9 4 0
6 1 0
11 8 1
8 1 1
7 17 1
18 17 1
11 16 1
3 2 2
9 8 2
2 4 2
6 12 2
