width 20
height 20
@@@@@@@@.@@@..@@@@@@
@@@@@@@@.@..@.@..@@@
@@@@@@@..@@.....@.@.
@@.@@@@.@.@.@@@.@...
@..@@.......@.@..@.@
..@.@@@.@@.@@..@....
@....@....@@.@.@@.@.
..@.@.@.@@.@.....@..
@@....@......@@.@@@.
@.@@.@@@.@.@..@..@.@
.........@@@.@.@@...
@@.@.@@.@.@@....@@.@
@@@@@@@@.....@@@...@
@@@@@@@..@.@@..@.@..
@@@@@.@.@.@@.@....@@
@@@@...........@.@@@
@@@@@.@.@.@@.@..@.@.
@@@@...@@@....@.....
@@@..@@.@.@.@..@.@.@
@@@@.......@..@@@...
14
18 4 0
14 5 0
15 4 0
14 16 0
10 15 0
9 11 1
3 10 1
5 4 1
6 15 1
4 10 1
7 10 2
8 10 2
8 15 2
18 17 2

2 4 0
4 9 0
19 13 0
14 2 0
12 14 0
2 3 1
7 18 1
7 8 1
18 7 1
17 5 1
14 15 2
18 19 2
3 10 2
6 4 2
