width 20
height 20
....@...........@..@
@.@.@@.@.@.@.@.@.@.@
@@......@@@..@@@....
@..@.@.@@@@@.....@.@
.@.@..@@@@@@.@@@@.@.
....@...@@@@.@@@@.@.
.@.@@.@..@@..@.@....
.@@@@.@@.@@@.@...@.@
.@.@.@.@@.@..@.@.@@@
@..........@...@.@.@
@@.@.@.@@.@@.@@.....
...@@@@@....@...@@.@
@.@..@..@.@..@.@...@
..@@..@..@..@.@.@.@@
@.@.@..@.@@.....@..@
.....@......@.@...@.
@.@.@..@.@@..@@.@...
...@@@..@@..@@.@..@.
@.@@@..@.@@.@....@..
@..@@@....@..@@.@@@.
14
18 9 0
18 10 0
3 16 0
6 16 0
2 17 0
0 15 1
1 0 1
6 1 1
17 0 1
7 0 1
13 14 2
13 18 2
18 3 2
8 18 2

5 5 0
8 7 0
16 10 0
1 1 0
12 4 0
18 11 1
18 10 1
6 19 1
17 16 1
0 13 1
5 6 2
8 16 2
2 15 2
14 14 2
