width 20
height 20
@@@.@@.@.@.....@@@..
@@.........@@@..@..@
@.@.@.@.@@.@.@.@.@..
....@.@...@@.......@
@.@.@.@@.@@..@@.@.@.
@.@@@@@@@@..@.@@....
@@@...@.@.@.@..@@.@.
@@@@@.........@@@@..
@@@@..@.@.@@@.@@@@@.
@@.@.@@@@@.....@@@@.
@...@.@.@..@@.@@@@@@
@@.@@...@@.@.@@@@@@@
@.....@@@....@@@@@@@
@.@.@....@.@..@@@@@@
.@@@..@.@@@..@@@@@@@
..@..@.@.@..@.@@@@@@
@.@@.......@...@@@@@
.....@.@.@.@.@..@@@.
@.@.@@@...@.@.@.@@..
@..@....@..........@
14
10 1 0
13 19 0
18 7 0
10 0 0
15 4 0
13 0 1
2 9 1
6 15 1
10 10 1
4 17 1
13 16 2
12 9 2
2 19 2
19 0 2

11 0 0
9 18 0
18 7 0
13 15 0
19 9 0
13 7 1
5 11 1
4 8 1
4 17 1
11 12 1
5 14 2
7 10 2
3 3 2
19 0 2
