width 20
height 20
......@.@.@.@@@@@@@@
@.@.@.........@@@@@@
@@.@.@@.@.@.@@@@@@@@
@........@..@.@..@@@
.@.@.@.@..@@...@.@@@
...@..@..@.@@@....@.
.@..@.@@.......@.@..
..@..@.@.@.@.@@.@.@.
.@.@....@..@.@......
....@.@.@.@...@.@.@.
.@@@.@@.@@@.@..@...@
.....@.@.@.@.@@.@@.@
@.@@...............@
..@.@@.@.@.@.@@.@.@@
@.....@@@@..@....@@@
..@.@.....@@@@@.@@@@
@.@@..@@.@.@@.@.@@@@
@@..@.@@.......@@@@@
@@.@.@.@@.@@.@.@@@@@
............@@@@@@@@
14
3 9 0
0 5 0
15 12 0
17 12 0
10 19 0
15 14 1
16 6 1
14 6 1
13 14 1
11 9 1
0 4 2
5 8 2
17 13 2
2 18 2

1 12 0
5 15 0
12 9 0
10 12 0
2 9 0
4 2 1
5 14 1
7 3 1
14 12 1
0 10 1
11 14 2
12 8 2
12 11 2
4 11 2
