width 20
height 20
@..@..@@@@.@.@@@@@@@
@@...@..@.....@@@@@@
@@.@...@.@@.@.@@@@@@
@@.@.@.......@@@@.@@
@@@.@..@.@.@@@@@...@
@@..@.@.@..@@@@.@.@@
@@@......@@.@......@
@@@@.@.@......@@@.@@
@@@@@@@@@.@.@...@.@@
@@@@.@.@.@.@..@@@@@@
@@@@.....@.@.@@@@@@@
@@@@.@.@@.....@@@@@@
@@@@@....@.@.@@@@@@@
@@@@.@.@@...@@.@@@@@
@@@......@@..@.@@@@@
@@.@.@.@.@@@....@@@@
.....@..@.@..@.@@@@@
.@@.@..@..@.@..@@@@@
...@.@...@.@.@..@@@@
.@@....@.......@@@@@
14
16 4 0
13 17 0
11 7 0
15 8 0
4 10 0
2 1 1
14 6 1
11 6 1
4 18 1
17 4 1
3 16 2
9 19 2
4 16 2
13 1 2

17 5 0
13 17 0
9 17 0
0 19 0
6 4 0
12 19 1
15 6 1
12 16 1
4 15 1
15 5 1
6 2 2
5 6 2
4 13 2
7 6 2
