width 20
height 20
@@...@....@@..@.....
@.@.@@@.@@.@@.@.@@@.
....@............@.@
@.@.@@.@.@.@.@@.@...
..@.....@...@@....@.
@..@.@.@@@.@..@.@.@@
..@@.@..@....@...@@.
@.@.@.@@.@.@@..@....
@@........@@.@@.@.@.
@@@.@.@.@.......@@..
@...@@.@..@@@.@.@.@.
.@@..@...@....@.....
.@@.@@@.@@@.@..@.@.@
....@.@@@@..@.@.@..@
@@@.....@@@@..@.@@..
@@@@@.@.....@.....@.
@@@@@@..@.@..@.@@@@@
@@@@@.@..@..@.@@@@@@
@@@@....@.@....@@@@@
@@@..@.@....@.@@@@@@
14
11 11 0
13 2 0
10 11 0
19 1 0
3 13 0
13 18 1
15 3 1
1 6 1
7 1 1
7 2 1
1 2 2
3 7 2
0 6 2
6 6 2

19 7 0
7 17 0
3 19 0
17 3 0
11 12 0
16 12 1
5 18 1
0 4 1
3 12 1
9 8 1
13 2 2
3 9 2
18 7 2
19 9 2
