width 20
height 20
@.@@@@@.@@.......@..
..@@@@.....@.@.@..@.
@..@...@.@..@@@.@...
@.@.@.@@@..@.@@.@.@@
.......@@@...@......
@.@.@.@.@..@.@.@@@.@
@@..@@@..@.@.@.@.@..
@.@...@@...@@@@....@
....@.@..@.@@@@@@@..
@@.@@@..@.@.@@@@.@@.
@.@.@.@.@....@....@@
..........@.@..@@@..
@@.@.@.@.@...@..@.@.
..@...@.@@.@...@....
@...@...@.@.@.@.@.@@
@@.@@@.@......@.....
@@@.@.@.@.@.@...@.@.
@@........@@@@.@@@..
...@.@.@.@@@@@..@@@.
.@.@.@@...@@@@.@@@@@
14
19 4 0
2 8 0
7 9 0
7 11 0
19 2 0
18 4 1
5 14 1
13 14 1
13 15 1
11 16 1
1 4 2
17 13 2
18 0 2
15 15 2

1 14 0
14 11 0
16 9 0
19 9 0
3 17 0
5 14 1
2 14 1
10 0 1
14 10 1
13 11 1
16 0 2
18 4 2
13 14 2
2 19 2
