width 20
height 20
@...@....@.@.@.@.@..
.@.@.@@.@..........@
......@...@.@.@.@@.@
@.@@@...@.@@.@.@@@..
@@...@@.@@...@.@...@
@.@.@@@....@....@@..
........@@@.@.@@.@.@
.@@@.@@.@...@.@.....
..@.@@@@..@.@@.@.@.@
.@...@@@.@...@....@@
.@.@@.@.@..@@..@.@@@
.@.@......@@..@@@@@@
....@.@.@@..@..@@@@@
@.@...@.@.@.@.@@@@@@
.@..@.@@.......@@@@@
.@@@....@.@.@.@@@@@@
.@..@.@..@@@@@@@@@@@
..@..@@.@@@.@@@@@@@@
.@.@.........@@@@@@@
.....@.@@@.@.@@@@@@@
14
0 14 0
1 6 0
4 2 0
18 7 0
10 1 0
0 2 1
2 4 1
18 8 1
2 16 1
13 10 1
5 11 2
3 19 2
19 5 2
7 18 2

11 9 0
7 3 0
9 8 0
7 12 0
6 3 0
16 0 1
16 9 1
18 5 1
13 15 1
0 12 1
7 2 2
7 18 2
1 12 2
2 1 2
