width 20
height 20
.@..@@@@@@..@.......
.@@.@.@@@@@..@.@.@.@
..@.....@@..@@@@@...
.@..@@.@.@.@.....@.@
...@..@@....@@.@....
.@...@...@.@@@@..@@.
@@@@...@@...@.@.@.@@
.@@.@@..@@.@@.......
.......@@....@@@@.@@
.@.@@.@@@@.@...@..@@
..@@.@.@..@.@.@.@..@
.@@......@@.......@.
.@.@.@.@...@.@.@@...
......@..@..@.@...@@
@.@.@.@@..@@..@.@...
@.@..@@@@@.@.@@@@@@.
@@@@@@@@......@@@@..
@@@@@@@@@@.@.@.@@.@.
@@@@@@@@@@@.........
@@@@@@@@@@@@@.@.@.@@
14
8 16 0
8 14 0
12 1 0
18 0 0
5 13 0
17 0 1
8 11 1
19 11 1
10 6 1
13 18 1
12 17 2
11 4 2
4 8 2
15 14 2

1 13 0
8 14 0
8 16 0
10 7 0
5 13 0
2 8 1
15 19 1
8 11 1
11 6 1
4 12 1
2 13 2
19 15 2
15 5 2
19 7 2
