width 20
height 20
@@..@@.@.@....@.@.@.
@@@......@.@.@......
@@@.@@.@....@.@.@@@.
@@@@@@@.@.@...@.@@@.
@@@@@@@..@..@...@@@@
@@.@@@@@...@.@.@@@@@
...@@.@@@@....@@@@@@
.@@@@..@@@.@.@@@@@@@
....@.@.@.@@.@@@@@@@
.@@@..........@@@@@@
....@@.@@.@@.@@@@@@@
.@@@.....@@.@@@@@@@@
..@.@.@.@.@.@@@@@@@@
.@.....@@.....@@@@@@
...@@.@..@@.@@@@@@@@
@@..@...@.@.@@@@@@@@
...@..@......@@@@@@@
@@..@@.@.@.@.@@@@@@@
@@@@@.....@..@@@@@@@
@@@@@.@@.@@@.@@@@@@@
14
3 8 0
6 11 0
5 15 0
3 0 0
14 1 0
19 2 1
6 9 1
10 9 1
8 11 1
7 1 1
12 9 2
13 13 2
7 16 2
12 18 2

5 8 0
5 11 0
5 13 0
10 6 0
5 7 0
11 16 1
12 16 1
5 6 1
7 11 1
0 12 1
13 13 2
17 1 2
11 4 2
3 0 2
