width 20
height 20
.@.@..@@@@@@@@@@@.@.
.....@.@@@@@@@.@....
@.@@...@@@@@@@...@@.
@@...@..@@@@@@.@@...
@@@.@..@@@@@@@@...@.
@@@@..@@@@@@@@@.@.@@
@@@@@.@@@@@@@@@@....
@@@@...@@@@@@@@@@.@.
@@@@@.@.@@@@.@@@...@
@@@@@....@....@.@@..
@@@@.@@.@.@.@...@..@
@@@.....@.@.@.@..@.@
@@@@@.@....@.@.@....
@@@.@@@@@@.......@.@
........@@.@.@@.@...
.@.@@@@.@.@@@.@@.@.@
..@@................
.@@@@.@.@.@@.@.@.@@.
@@@@@..@..@@@...@...
@@@@@.@@@..@@@.@@@.@
14
6 7 0
16 11 0
18 14 0
16 13 0
5 14 0
1 16 1
18 9 1
5 0 1
17 10 1
19 7 1
6 4 2
0 1 2
2 1 2
17 16 2

6 7 0
14 12 0
16 6 0
5 9 0
4 16 0
4 3 1
0 0 1
5 8 1
1 16 1
13 9 1
19 1 2
15 9 2
15 5 2
9 16 2
