width 20
height 20
..@@@@@@@@.....@....
.@@@@@@@@@@.@.@.@@.@
..@@@@@@@@@@........
@.@@@@.@@@@.@.@.@.@@
...@.....@@....@....
@.@..@.@@.@.@.@.@.@.
....@.......@@..@@..
@.@.@@.@.@.@@.@.@@@.
@@@@...@..@.@....@..
@...@.@.@.@..@.@@..@
@@@.@....@.@...@.@..
@.@.@@@.@@...@@....@
....@@@@.@.@@.@.@.@.
@.@@.@...@.@@....@..
.......@@.....@.@@.@
.@.@.@..@.@.@.@.@...
..@...@@@@..@..@.@.@
.@.@.@.@@.@..@......
...@.@......@..@@.@.
.@@....@@@@@@@...@..
14
18 0 0
10 6 0
2 4 0
13 2 0
10 16 0
18 1 1
18 9 1
13 3 1
14 18 1
3 14 1
19 2 2
18 19 2
9 17 2
7 10 2

2 17 0
17 4 0
19 4 0
0 14 0
10 18 0
12 14 1
1 7 1
0 12 1
1 9 1
9 8 1
17 9 2
17 17 2
7 6 2
5 4 2
