width 20
height 20
..@...@......@.@..@.
@...@@@@.@.@.@...@@.
..@...@...@..@.@.@..
@..@.@.@@@.@..@..@@.
@.@.@...@....@.@....
.....@@..@@@....@.@@
@.@.@.@.@.@.@.@.....
@@...........@.@@.@.
@.@.@.@.@@.@...@.@@.
...@...@@.@@@.@.....
.@..@.@.@...@.@.@.@@
.@.@......@@..@..@@.
@...@.@.@@@@@...@.@.
..@@.@@.@.@@@@@.....
@.@..@.....@@@@.@.@.
...@.@@.@.@.@@@@@@..
.@.....@.....@@.@@@.
.@@.@.@.@.@.@.@.@.@.
.@@@.....@@.@......@
....@@.@......@.@.@@
14
2 15 0
2 10 0
11 4 0
15 3 0
19 4 0
19 11 1
8 14 1
5 0 1
0 2 1
5 16 1
12 1 2
8 5 2
7 12 2
4 3 2

6 18 0
19 17 0
6 16 0
1 8 0
7 7 0
3 16 1
11 16 1
19 12 1
12 4 1
5 7 1
15 11 2
7 4 2
19 4 2
2 16 2
