width 20
height 20
@@@...@........@...@
@@@@.@.@.@.@@@..@.@.
@@@@...@..@...@.@...
@@@@.@@..@..@....@@.
@@.....@.@.@..@.@.@.
@.@.@@@@.@@.@.@.....
........@@..@.@@.@@@
@@.@.@@...@.....@@@.
....@@@@.@..@.@..@..
@@@.@@@....@@@..@.@.
@@@@.@.@.@@@@@@.....
@........@@@@@@.@@.@
..@.@.@@@@@@@@....@@
@..@@@@@.@@@@.@@.@@@
@.@.......@......@@@
...@.@@.@..@@.@.@@@@
.@.@.@.@..@....@@@@@
@@..@..@@..@@.@@@@@@
.@.@.@....@@@...@.@@
.......@@.@@..@.....
14
18 19 0
8 3 0
7 6 0
1 13 0
18 11 0
4 10 1
4 7 1
17 1 1
19 9 1
14 14 1
19 4 2
14 12 2
15 15 2
11 8 2

16 13 0
12 7 0
14 18 0
13 4 0
10 17 0
11 0 1
19 7 1
4 15 1
5 0 1
14 14 1
9 2 2
8 8 2
12 2 2
8 5 2
