width 20
height 20
@@@@@@.@@@@@@@.@.@.@
........@@@@@@......
@.@.@@.@@@@@@..@.@.@
...@@....@@...@.@..@
@@@..@.@@.@@@...@.@.
@..@......@@@@@..@..
@.@..@@.@@@@@.@.@.@.
..@.@.@@.@@@........
@.........@.@.@.@@.@
@@.@.@.@@......@....
@.@@..@@@@@.@.@@@.@.
...@.@@@@@...@@@@..@
@.@@.@@@@..@@.@...@@
..@.@.@@@@..@..@@@.@
@.......@@.@..@@@...
..@.@.@@.@.@.@.@.@.@
@.@@................
@@@@.@.@.@.@@.@.@.@.
@@@..@..@@@.@@..@@..
@@@@..@.......@.@@@@
14
6 16 0
18 16 0
14 16 0
17 10 0
7 14 0
5 13 1
15 17 1
10 17 1
19 7 1
6 2 1
13 9 2
19 14 2
13 14 2
6 18 2

4 1 0
10 16 0
15 1 0
6 16 0
0 3 0
3 1 1
18 3 1
10 17 1
11 10 1
12 11 1
19 14 2
13 16 2
8 17 2
6 4 2
