width 20
height 20
@@.@...@@@@..@.....@
....@.@.@@@.@@@@.@..
@@.@.....@...@...@@@
.@...@@.@.@.@.@@...@
..@.@@....@...@..@@@
@.@...@.@.@.@..@..@@
....@..@...@.@...@@@
.@.@.@@.@.@....@.@@@
..@...@....@.@.@@@..
.@@@.@..@@..@..@@.@.
@......@@.@@@@......
.@.@.@..@..@.@.@@@.@
.@@..@@...@..@.@....
..@@.@@.@@.@.@@@.@.@
.@.@.@..........@...
......@.@.@@@@.@.@.@
.@@@.@..@@@..@.@.@..
@.@.@.@.@.@.@.@....@
................@@..
.@.@@@.@@.@.@@@.@..@
14
3 8 0
5 0 0
10 11 0
11 3 0
7 14 0
19 9 1
13 4 1
16 7 1
14 15 1
15 2 1
15 14 2
17 3 2
13 14 2
5 10 2

9 19 0
5 2 0
19 18 0
18 3 0
3 5 0
2 19 1
7 12 1
19 1 1
13 18 1
9 14 1
7 13 2
12 7 2
15 10 2
16 10 2
