width 20
height 20
@@@...@.@@@.@..@..@@
@@@@.@@.@@....@..@.@
.@@@..@.@.@.@@@@....
..@..@.......@@.@@.@
.@.@..@.@.@.@.@.....
.....@@..@......@.@.
.@.@.@.@@@@.@.@..@..
..@.....@..@@@.@@.@.
.@.@.@.@@@..........
...@@.@.@..@.@@@.@.@
@@......@@..@.@.@.@@
..@.@.@....@......@.
.@..@@@@.@.@@.@.@...
..@.....@@@.@..@..@.
.@@.@@.@.@@.@.@.@.@@
...@.............@.@
.@@@@.@.@.@@.@.@....
...@...@....@@@@@@@.
.@@@@.@.@@.@.@.@.@..
........@@@@.......@
14
15 10 0
18 8 0
9 3 0
0 16 0
3 11 0
13 4 1
11 13 1
16 9 1
5 18 1
7 5 1
7 10 2
18 15 2
4 0 2
6 3 2

14 15 0
1 17 0
6 15 0
0 12 0
2 10 0
14 5 1
10 9 1
9 16 1
11 6 1
11 5 1
6 14 2
4 15 2
5 4 2
7 9 2
