width 20
height 20
@@@@@@@@@@.@@@..@@@@
@@@@@@@@@...@@.@.@@@
@@@.@@@@..@.@@....@@
@@..@.@@@..@@..@@...
@@.@...@..@@.@@.@.@.
.....@@.@..........@
@.@@......@.@.@.@.@.
@@...@.@.@...@.@....
@@@.@.@@@.@.@@..@.@.
@@.....@......@.@@..
@.@.@.@@@.@.@.....@@
..@..@@@..@@..@@.@.@
@...@.@..@@.@@......
.@.@...@@....@.@.@.@
....@@.@.@@.@@.@@.@.
@.@@.@....@.@@....@.
@@.....@.@...@.@.@..
@@@.@.@.@.@.@@@@.@.@
@@@@................
@@@@@.@.@.@.@.@.@.@.
14
9 3 0
11 17 0
0 14 0
16 13 0
11 7 0
19 7 1
14 15 1
5 17 1
1 11 1
12 18 1
14 8 2
8 9 2
17 5 2
6 4 2

15 18 0
0 13 0
16 16 0
18 17 0
18 11 0
2 5 1
10 5 1
14 15 1
17 19 1
1 15 1
7 12 2
15 5 2
17 14 2
17 8 2
