width 20
height 20
.@..@..@@.@.@@@@@@@@
...@..@@@......@@@@@
@.@@@.@@@.@@@.@.@.@@
.......@.@.@.......@
@.@.@.@......@@.@.@@
.@.@....@.@.@..@..@@
....@@@.@@..@.@..@.@
.@@.@....@@@...@@..@
.@.@.@.@@.@@.@@..@..
................@..@
@.@.@.@@@@@@@.@...@.
...@.@.@.@.@.@..@...
.@...@.......@@@.@@.
@@.@@.@@.@.@........
.@.@..@...@..@.@@.@.
...@@...@.@@@@@.@@..
.@.@.@@..@........@.
.@@....@@.@@@.@.@@.@
...@.@.........@.@.@
@@....@@.@.@.@......
14
7 14 0
11 14 0
11 6 0
9 1 0
3 19 0
1 10 1
10 12 1
14 1 1
2 12 1
7 7 1
7 15 2
8 11 2
9 17 2
3 0 2

0 18 0
15 11 0
6 15 0
9 15 0
0 0 0
14 1 1
1 4 1
2 1 1
8 12 1
10 18 1
18 8 2
8 11 2
18 13 2
2 0 2
