width 20
height 20
..@@.@.@@@@@@@@@@@@@
@.......@@@@@@@@@@@@
..@@.@.@..@@@..@@@@@
@.@@@...@..@..@.@@@@
...@.@.@..@@.@@..@@@
.@...@..@.......@.@.
@..@.@.@@@.@.@@.....
.@..@@@.@@@.@@@.@.@.
...@@@@..@...@.@@@..
.@@@@@..@.@.@...@.@.
.@@@@.@.......@@....
..@.....@.@.@@@.@.@@
@...@.@.@@@.@......@
.@@.@@.@.@.@.@.@.@..
................@.@@
@@@.@.@@.@@@.@.@....
@@@@...@@@.@@@@..@@.
@@@.@@.......@@.@...
@......@.@.@...@.@.@
..@@.@.@@..@.@......
14
6 6 0
8 13 0
1 0 0
11 14 0
19 19 0
17 10 1
15 17 1
2 18 1
6 11 1
3 12 1
7 11 2
7 10 2
18 12 2
15 4 2

10 10 0
4 14 0
3 5 0
15 12 0
19 19 0
11 14 1
19 15 1
19 17 1
8 2 1
3 13 1
10 5 2
7 17 2
16 13 2
15 3 2
