width 20
height 20
..@...@@@..@.@.@@@@@
.@.@.@.@@@......@@@@
........@.@.@@.@@@@@
.@@.@.@....@....@@@@
.@.@.@@.@.@..@.@.@@@
@....@.@@.@@@.....@@
..@@.......@..@.@..@
@@..@.@@.@..@..@..@.
...@.@...@.@.@.@@...
.@....@.@.......@.@.
.@.@.@.@.@@@.@@.@@..
@@@.......@.@@@@@.@.
....@.@.@....@@.@...
@.@..@...@@@......@.
..@.@@.@.@@@@@.@.@@@
.@...@..@@@.....@@@@
..@.@..@.@..@@.@@@@@
.@@@@@....@@....@@@@
@@@@@..@.@...@.@@@@@
@@@@@@.@.@@@..@@@@@@
14
9 5 0
9 3 0
2 1 0
8 11 0
0 12 0
0 2 1
3 14 1
15 1 1
15 13 1
9 9 1
0 15 2
6 10 2
9 11 2
10 18 2

10 18 0
0 6 0
5 2 0
1 0 0
17 8 0
2 5 1
8 6 1
0 8 1
10 3 1
9 9 1
6 14 2
8 8 2
10 16 2
0 17 2
