width 20
height 20
.@.@@@.@.@@@@@@.@..@
....@.....@@@....@..
@@.@.@@@.@.@.@.@...@
.@...........@@@.@@.
...@.@.@.@.@........
.@@.@@@.@.@@.@.@@@@.
.@...@........@@.@@.
...@..@.@@.@@.@..@.@
@.@.@.@@.@@@.@.@....
@@.....@.........@.@
@@@.@.@..@.@.@.@@@..
@@..@.@.@@@.@@@....@
@@.@.@.@.@@....@.@..
..........@@.@....@.
.@.@.@.@@.....@.@..@
..@@@@@@.@.@.@..@.@@
.@.@.@.@..@.@.@@@@@@
........@......@@@@@
@@@.@.@...@.@.@@@@@@
@@@.@@..@@@.@.@@@@@@
14
12 6 0
7 17 0
6 6 0
0 5 0
1 13 0
13 19 1
2 6 1
5 7 1
11 11 1
5 18 1
9 6 2
5 1 2
2 13 2
19 4 2

7 11 0
3 13 0
14 9 0
15 0 0
8 1 0
9 17 1
3 19 1
0 6 1
8 3 1
16 7 1
0 14 2
5 11 2
10 6 2
13 9 2
