width 20
height 20
@@..@@..@.@.....@@@@
@@@.@..@....@.@@.@@@
@@...@...@@@......@@
...@..@@...@.@.@.@.@
.@.@.@.@.@@.@.@.@@.@
..@................@
.@@.@@.@.@.@.@.@.@.@
@.@@@@@@.@.@@..@.@..
....@@@@@...@.@.@@.@
.@.@@@@@.@.@.@......
..@@@@@..@.@.@@.@.@.
.@.@@@..@......@.@..
...@@@.@.@@.@.@@..@.
@@.@.......@..@.@..@
@@..@@@@@.@.@.@...@@
@.@...@.........@@.@
@...@.@@.@@@@.@.....
..@@.@.@.@@.@@..@.@@
@.@...........@@..@.
....@.@@.@.@.@@@@...
14
9 0 0
13 18 0
0 3 0
8 16 0
13 5 0
17 13 1
11 5 1
7 0 1
7 11 1
18 4 1
6 4 2
5 3 2
12 0 2
13 1 2

17 10 0
8 6 0
9 14 0
9 5 0
16 11 0
17 12 1
2 12 1
10 9 1
10 18 1
5 13 1
5 16 2
6 4 2
15 5 2
8 17 2
