width 20
height 20
@@@@@@@@@@.@@.@.@..@
@@@@@@@@@@........@.
@@@@@@@@@@@.@@.@@...
@@@@@@@@@@@.@@...@@.
@@@@@@@@@@@...@.@@..
@@@@@@@@@@@@@@.@@.@.
@@@@@@@@@@@.........
@@@@@@@@@@@.@.@.@.@@
@@@@@@@@@@.@...@@@@@
@@@@@@@.....@.@.@.@@
@@@@@@@@.@.@@.....@@
@@@@@@.@..@@@.@@@..@
@@@@@....@.@.@.@.@.@
@@@@@@.@............
@@@@@@@@@@.@.@.@@@.@
@@@@@@.@@@@.@.@@....
@@@@@@....@...@..@.@
@@@@@@@.@..@.@.@..@@
@@@@@@@.@@.......@@@
@@@@@@@.@..@.@.@@@@@
14
18 4 0
15 0 0
12 8 0
16 13 0
11 6 0
17 17 1
13 13 1
11 3 1
7 16 1
16 18 1
14 18 2
19 5 2
13 18 2
15 6 2

16 13 0
7 19 0
13 10 0
17 0 0
13 8 0
12 4 1
8 11 1
18 6 1
18 15 1
13 7 1
19 6 2
7 17 2
13 18 2
14 19 2
