width 20
height 20
..@@@@@@@@@@@@@@@@@@
.@@@@@@@@@@.@@@@@@@@
..@@@@@@@@..@@@@@@@@
.@.@.@..@..@@@@@@@@@
...@...@.@..@@@@@@@@
.@.@.@.....@@@@@@@@@
@.....@@@.@@@@..@@@@
..@@.@.@.@.@@@.@@@@@
@.@......@......@@@@
...@.@.@..@.@@.@.@@@
@.@@@@@..@.@......@@
..@@.@@@....@@.@.@.@
.@....@.@@.@.@.@....
..@@.@........@..@.@
.@.....@.@.@@.@@..@@
@..@.@..@..@.@...@@@
@@..@..@.@@@...@...@
@..@@@.......@..@.@@
@@..@@.@.@@.@.@@....
@..@....@@.....@@.@.
14
1 7 0
4 13 0
16 10 0
10 7 0
15 15 0
9 17 1
2 3 1
13 19 1
1 9 1
2 18 1
6 5 2
5 14 2
17 19 2
15 8 2

12 17 0
18 12 0
8 10 0
3 8 0
6 19 0
10 14 1
18 18 1
0 13 1
2 5 1
4 6 1
0 7 2
13 18 2
3 6 2
11 17 2
