width 20
height 20
......@..@@@@@@@.@@.
@.@.@@..@@@@@@@..@..
@..@@@@.@@@@@..@...@
..@@@@...@@@..@.@@..
@..@@..@..@..@@....@
@.@..@@@.@.@.@@.@.@@
...@.......@..@..@..
@@...@.@.@...@..@.@.
...@.@.@.@.@..@.....
@.@.@.@.@.@.@@..@.@.
............@.@.@@..
@.@.@.@.@@@.....@.@.
.@@@.@.@....@.@.@...
.@@@...@.@@..@.@@.@@
..@..@..@@@.@..@@.@@
.@..@..@.@.@..@...@.
.@.@@@.....@.@.@.@..
....@@.@.@........@.
.@.@@.@.@..@@.@.@...
.@@.......@@@@..@.@.
14
19 15 0
5 10 0
5 15 0
1 3 0
7 14 0
14 13 1
7 11 1
17 2 1
17 8 1
12 7 1
2 18 2
16 4 2
0 16 2
12 15 2

15 18 0
12 16 0
16 4 0
3 0 0
8 15 0
13 17 1
4 14 1
11 10 1
11 17 1
18 4 1
13 2 2
9 16 2
12 3 2
0 8 2
