width 20
height 20
.@.@@@@@...@....@.@@
......@..@.@@.@.....
.@.@@@@@.@@@@@@@@@.@
..@@@@@@.@.@@.@@....
.@.@.@@@.........@.@
.......@@.@.@.@@@..@
@.@@.@....@.@.@.@@..
....@@@.@..@@@....@.
@.@@@@.@@@..@@@.@...
..@@.@..@@@....@@.@.
@.@...@..@.@.@...@..
...@.@.@.@..@..@@@@.
.@.........@@@.@@@@.
.@.@.@@.@.@@@..@@...
@.@@@.@..@@@@@@...@.
...@@...@@.@@@@@@..@
@.@.@.@.....@@@@@@@@
......@@.@.@.@@@@@@@
@.@.@.@@@.......@@@@
@..@@@@@@@.@.@.@@@@@
14
6 12 0
4 6 0
3 17 0
0 5 0
2 2 0
18 2 1
10 0 1
10 18 1
1 11 1
11 11 1
0 7 2
1 14 2
2 1 2
10 4 2

16 7 0
10 16 0
19 10 0
13 5 0
19 7 0
18 2 1
1 8 1
4 13 1
15 1 1
13 11 1
2 2 2
7 9 2
10 7 2
8 2 2
