width 20
height 20
..@...@.@.@@@@@@@@@@
@.@@@.@...@@@@@@@@@@
........@..@@@@@@@@@
.@.@@@@..@.@@@@@@@@@
.@@@@@..@.@.@@@@@.@@
...@@@@.....@@@....@
.@@.@@@.@.@@.@.@.@@.
.....@.@..........@.
@.@.@@..@.@@.@@.@.@.
@@@..@.@@.@..@.@....
....@...@@.@...@@.@@
@.@.@.@.@....@@.....
...@..@@@@.@..@.@.@@
@@@.@..@@@..@..@....
..@...@@@..@..@@@.@.
@...@....@.@@..@@@..
@.@..@@.@...@.@@@@@.
...@@..@.@.@@@@@@@@.
@.@@.@.....@@.@@@@@@
.......@.@.....@@@@@
14
1 12 0
0 3 0
7 11 0
19 14 0
9 2 0
7 6 1
2 12 1
3 10 1
11 16 1
3 11 1
7 1 2
7 10 2
11 5 2
18 11 2

3 0 0
5 12 0
2 19 0
3 9 0
5 15 0
0 3 1
10 18 1
15 12 1
13 18 1
0 4 1
6 7 2
1 5 2
7 10 2
18 5 2
