width 20
height 20
...@.....@@....@....
@.@@@.@@.@..@.@.@.@.
..@@@@@...@..@.....@
@.@@@.@@@.@.@@@@@@..
...@...@....@@...@.@
@.@.@.@.@.@....@....
@..........@.@@..@.@
@.@.@.@@@.@@.@..@.@@
...@@..@@@..@.@...@@
@.@...@@@.@.....@@.@
...@@@@@....@.@@.@..
@.@..@@@@.@.@@.@...@
....@......@.@...@.@
.@.@.@.@.@@....@..@.
..@@...@@..@.@.@.@..
.@...@@.@@.@.@@.@.@.
..@.@...............
@.@...@@.@.@.@.@@.@.
@@..@...@@@@@....@..
@@@.@@.@@@@@@@.@.@@.
14
6 19 0
0 0 0
3 6 0
4 14 0
1 4 0
4 11 1
12 2 1
17 16 1
8 1 1
17 8 1
18 3 2
19 14 2
13 16 2
11 8 2

8 6 0
7 18 0
10 14 0
2 10 0
16 19 0
4 14 1
7 5 1
2 6 1
14 19 1
1 10 1
9 16 2
3 5 2
16 10 2
5 17 2
