width 20
height 20
...@@@@@.@@@...@...@
.@@.@@@...@.@.@.@.@@
.@...@.@.@..........
..@.@......@@.@.@.@@
@...@.@@.@.@.@.@.@..
..@@....@.@....@..@.
@....@@.....@.@@@...
.@.@.@.@.@.@.@.@@@@.
.@.@@...@.@.....@...
......@....@.@.@.@.@
.@.@.@@.@.@@@.......
..@@@@.@@.....@.@@.@
.@.@.@....@.@.@@@@@@
......@.@..@....@@@@
@.@.@..@@.@@@.@.@@@@
.@.@.@..@..@..@@@@@@
.......@..@.@...@@@@
.@.@@@..@...@.@.@@@@
..@@@@@.@.@..@..@.@.
.@@@@@@.@@..@@@.....
14
7 6 0
14 10 0
9 6 0
0 17 0
16 4 0
17 19 1
11 17 1
2 16 1
17 0 1
1 14 1
4 2 2
19 10 2
1 18 2
2 15 2

16 5 0
13 11 0
9 5 0
7 15 0
15 14 0
1 11 1
10 4 1
14 16 1
14 18 1
1 13 1
8 4 2
3 2 2
18 6 2
1 3 2
