width 20
height 20
@@@@@@@@@@@@@@@...@.
@@@@@@@@@@@@@@@@.@..
@@@@@@@@@@@@@@@....@
@@@@@@@@@@@@@@@.@@..
@@@@@@@@@@@@@@.@@.@.
@.@@@@@@@@@@@..@....
....@@@@@@@@@@..@.@@
@.@.@@.@@@@@@..@....
@@.......@@@.@...@.@
@.@@@.@@..@....@.@@@
...@.@...@@@@.@@.@.@
.@....@.@.@..@.@....
@@.@.@.....@.....@.@
@.@..@.@.@@@.@.@..@@
...@....@.....@..@@@
@.@@.@.@@.@@.@.@....
....@.......@....@@@
@.@@.@@.@@.@.@.@..@@
..........@.....@@.@
@.@.@.@.@..@.@@.....
14
15 3 0
16 17 0
4 15 0
8 10 0
18 18 0
5 16 1
12 12 1
15 19 1
14 16 1
16 13 1
8 13 2
12 18 2
16 8 2
14 8 2

10 16 0
16 13 0
19 15 0
18 19 0
2 8 0
1 6 1
15 8 1
19 1 1
8 10 1
18 18 1
19 0 2
1 10 2
10 14 2
3 8 2
