width 20
height 20
@@..@@@..@@@@@@@@@@@
..@..@..@.@@@@@@@@@@
.@..@.@.....@@@@@@@@
..@....@@.@..@@@@@@@
.@@@.@..@@..@@@@@@@@
..@@@..@..@..@@@@@@@
.@@@@@...@@.@@@@@@@@
.@@@@@.@@.@.@@@@@@@@
.@..............@@@@
...@.@@.@.@.@.@.@@@@
.@.@@.@@@.@@.@..@@@@
..@.....@@.@.@@..@@@
.@..@.@........@@@@@
...@@@..@.@.@.@@@@@@
@@@.@.@@.@...@@@@@.@
@.........@.@.@....@
@@@.@.@.@.@....@.@..
@@...@@@@@@.@.@.@.@.
@@.@@.@.@@.@@.......
@@............@.@.@.
14
1 11 0
13 19 0
12 12 0
12 10 0
8 8 0
11 17 1
11 5 1
6 11 1
9 7 1
6 3 1
17 18 2
7 9 2
11 15 2
12 8 2

10 19 0
12 11 0
5 15 0
3 16 0
19 17 0
7 2 1
10 8 1
7 6 1
9 16 1
3 15 1
9 2 2
4 17 2
7 13 2
5 5 2
