width 20
height 20
.@.@.@.....@..@@.@..
.......@.@...@....@.
@.@.@.@@@@@.@@@@.@..
@@...@@@@..........@
@.@.@@@@.@.@.@.@.@..
...@@@@.....@.@@@..@
@.@.@@@@.@.@@..@.@.@
..........@...@.....
@@.@.@@@.@@@.@@@.@@@
@...@..@......@...@@
.@.@.@.@.@.@.@.@.@@.
.@@.......@@@@...@..
....@.@.@@@@.@.@.@.@
@.@.@.@@.@@@....@...
..@@.@.@..@.@@.@.@.@
@........@..........
@@.@.@@.@.@.@.@.@.@@
@.@.@......@.@...@..
......@.@.@@..@.@@.@
@.@.@..@...@@.......
14
18 3 0
19 13 0
19 15 0
8 8 0
5 17 0
16 6 1
15 19 1
5 15 1
9 3 1
15 17 1
13 15 2
9 11 2
9 17 2
8 5 2

4 15 0
19 7 0
0 12 0
12 13 0
5 17 0
19 4 1
13 3 1
2 9 1
0 18 1
7 5 1
1 4 2
3 2 2
0 10 2
4 8 2
