width 20
height 20
@..@.....@@..@@.@.@.
@.@.@@.@.@..@@......
....@..@@@@..@.@@@@.
@.@..@...@..@....@..
.@.@.@.@..@..@.@@@@.
......@..@@.@.@.@@..
@.@@.@.@.@.........@
..@@@......@.@@.@.@@
.@.@@.@@.@.@.@.@.@@@
.......@..@@......@.
.@@.@.@.@.@.@.@.@.@.
@....@@......@@@..@.
@.@.@@.@@.@.@@@.@...
@.@.@......@@@....@.
.@.@.@@.@@@.@.@.@@@.
.....@.@.@.......@@.
.@@@.......@@@.@.@.@
...@.@.@@.@@@..@....
.@@@@@@......@..@.@@
...@@@@@@.@@@@@.@.@@
14
19 12 0
5 0 0
17 6 0
14 2 0
4 11 0
13 17 1
1 17 1
3 10 1
15 12 1
1 1 1
15 14 2
4 5 2
4 17 2
11 12 2

19 15 0
10 8 0
4 4 0
0 17 0
18 5 0
14 3 1
4 17 1
9 16 1
8 4 1
2 17 1
6 3 2
19 0 2
16 1 2
13 17 2
