width 20
height 20
@@@..@..@..@@.@....@
@@@.@.@.@.@.....@@..
.@..@.......@.@@.@.@
..@...@@@.@..@@...@@
.@.@@@.@.@.@.@.@.@.@
...@.@..............
.@.....@.@.@.@.@.@.@
@..@@.@.@@@@@...@...
@.@..@...@.@.@@@@@.@
.@..@@.@.......@@...
...@@.@@@@@@@.@.@@.@
.@.....@@@..........
.@@.@.@@@..@.@.@.@.@
@@@@...@.@..@.@.@@..
@@@@@@.....@@.@..@@.
.@@@@.@.@.@@@...@..@
...@...@...@.@.@@@..
@.@.@@.@@@.....@@.@.
...........@.@......
@.@@.@.@@.@..@@@.@.@
14
13 17 0
2 6 0
0 16 0
1 5 0
6 9 0
1 19 1
19 13 1
14 6 1
9 0 1
18 2 1
18 13 2
18 10 2
11 5 2
7 5 2

18 8 0
12 11 0
3 8 0
6 6 0
17 11 0
14 7 1
3 9 1
12 9 1
16 2 1
13 1 1
11 17 2
18 11 2
3 2 2
2 18 2
