width 20
height 20
@..@.........@.....@
@.@@.@@.@@@@..@@.@..
@..@@....@.@@@...@@@
@@...@.@@....@.@..@@
...@...@..@@..@..@@@
@@.@.@@@@.@@@@.@..@@
@@..@@@@..@@@....@@.
.@.@.@.@.@.@.@.@....
..............@..@@@
@.@.@.@.@.@.@.@.@@..
...@..@@.@..@...@.@.
@.@@@.@@..@@..@.....
...@.@@.@..@.@.@.@.@
.@........@....@@.@.
.@.@.@@.@..@@@..@...
..@@@.@@..@@.@.@.@.@
.@.@.....@@........@
@..@.@.@...@.@.@.@..
@@.@..@..@@...@@@..@
@@...@@@.@..@@@@@@..
15
8 18 0
3 8 0
7 13 0
11 8 0
8 15 0
14 15 1
19 17 1
2 3 1
9 9 1
13 13 1
12 12 2
3 13 2
6 4 2
5 18 2
2 13 2

12 1 0
18 1 0
7 12 0
3 3 0
12 11 0
2 16 1
17 14 1
9 17 1
10 8 1
13 13 1
13 10 2
13 11 2
4 14 2
4 10 2
12 13 2
