width 20
height 20
@@.@..@...@@.@@@@@@@
.....@.@.@.@..@@.@@@
.@.@.......@.@.@.@@@
.@..@.@.@@..........
..@..@.@...@@.@@@@.@
.@..@..@.@@...@@....
@@@@@.@.@@@.@..@.@.@
@@@@.....@...@@...@@
@@@@@.@.@@@.@@@@.@@@
@@@@@@...@...@@@@@.@
@@.@@..@.@@.@.@@.@..
@..@..@.@.@........@
@.@.@.......@.@.@.@.
......@.@.@.@@...@@.
@.@.@..@@@@@.@@@....
...@@@.@..@@..@..@.@
@.@...@.@....@.@@...
....@.....@.@....@.@
@.@.@.@@.@..@.@.@...
@@@@...@..@....@@@.@
15
14 19 0
5 5 0
13 12 0
18 10 0
18 19 0
14 2 1
1 18 1
16 14 1
1 13 1
5 19 1
8 15 2
2 3 2
11 17 2
16 2 2
10 3 2

18 4 0
3 13 0
8 17 0
14 17 0
1 18 0
1 12 1
2 17 1
0 13 1
14 19 1
11 5 1
1 16 2
14 3 2
1 17 2
6 17 2
12 0 2
