width 20
height 20
...@@@@@@@...@......
@.@.@@@@@.@.@@.@.@@.
.....@@@........@...
@.@@.@.@.@@.@@.@@@.@
@@@......@@@@@@@@@..
@...@.@.@.@.@@.@@.@.
@@.@@..@@...........
@@.@@.@@@.@.@@.@.@@.
@.@@.@.@...@@.@..@.@
..@......@@.....@...
@..@.@@.@...@.@.@@.@
..@...@@@.@..@@@....
@...@....@@.@.@.@.@@
@@@..@@.@.@@........
@.@.@.@@@....@@.@.@.
..........@@..@..@..
.@@.@.@.@.@.@@@.@@.@
..@..@@@....@...@..@
.@..@@@.@.@.@@.@.@..
..@..@.....@......@.
15
13 17 0
16 11 0
15 15 0
4 11 0
19 7 0
18 17 1
7 16 1
8 4 1
14 18 1
2 10 1
17 17 2
1 9 2
2 15 2
3 13 2
12 11 2

1 3 0
6 3 0
2 5 0
5 12 0
18 8 0
15 0 1
6 8 1
19 6 1
16 13 1
3 11 1
9 8 2
7 9 2
17 0 2
4 17 2
17 2 2
