width 20
height 20
.@.@.@.@@.@.@@@@@@@@
..............@@@@@@
.@@.@@.@.@@@.@.@@@@@
..@..@..@.......@@@@
.@.@@.@@.@@.@.@@@@@@
.......@.@@@.@@..@@@
@.@.@@.......@.@....
...@.@.@@.@@.....@@.
@@....@@@@.@@.@@...@
.@.@.@@@....@@...@..
.@@..@@.@@.@..@@@..@
.@.@.@@.@....@@..@..
.@...@@.@@@@..@.@..@
...@.@.......@..@@..
.@..@@.@.@.@...@...@
@..@@.@.@.@@@@..@@..
.@.............@@@@.
...@.@.@.@@.@.@@@@@.
@.@@@..@@.@@..@@@@.@
..@@@@......@.......
15
2 17 0
0 4 0
19 15 0
7 10 0
12 12 0
17 8 1
6 7 1
15 13 1
2 13 1
12 7 1
7 3 2
10 3 2
7 15 2
11 17 2
0 0 2

19 19 0
15 19 0
1 5 0
4 7 0
19 11 0
16 7 1
12 6 1
0 3 1
11 16 1
0 13 1
6 3 2
4 11 2
12 18 2
8 13 2
10 11 2
