width 20
height 20
@@@@@...@.@.@..@.@@.
@.@@@@@.......@.....
....@..@@.@@@@@@.@@.
@.@..@.....@....@...
...@.@.@.@...@.@@@.@
@.@.@.@@@..@..@.@...
......@@@.@@@.....@.
.@.@.@.@.@.@.@@.@@..
@@@..............@@@
@@@@.@.@@@.@.@@.@@..
.@@@@.@...@.@@.....@
.@.@..@@.@@.@.@@.@..
.....@.@..@.....@..@
@.@@.....@.@@.@@@@..
...@@@.@......@.@.@.
@.@@@@@@@.@@@.......
@@@@@@@@@@....@.@.@.
@@@@@@@....@.@...@.@
@@@@@@@.@.@@..@@...@
@@@@@@...@...@@@@@.@
15
8 13 0
11 8 0
5 5 0
10 7 0
8 12 0
16 6 1
6 19 1
9 15 1
14 8 1
6 8 1
10 19 2
11 12 2
1 4 2
9 1 2
10 9 2

3 3 0
12 5 0
9 10 0
12 16 0
1 6 0
7 13 1
17 16 1
16 11 1
1 13 1
0 4 1
12 14 2
1 1 2
6 4 2
6 12 2
8 1 2
