width 20
height 20
@@@.@@.@..@@@@@@@@@.
@@..@@..@..@@@@@.@@.
@@@.@..@..@.@@@.....
@@@..@...@...@@@.@.@
@@@.@..@.@.@...@.@.@
......@.@..@.@@...@.
@.@.@.....@.@@.@.@..
...@.@@.@..........@
@.@..@@@@.@.@.@@.@..
....@@@..@...@..@..@
@.@.@@..@@@.@.@..@..
@@..@.@.@@@@....@.@.
.@@.....@@@.@@@.....
.@..@.@@@....@.@@.@.
..@.@.@@..@@....@.@.
@...@@@.@.@@.@@....@
@.@.@...@...@@.@.@@.
@..@@@@...@....@....
..@@@.@.@.@@.@.@.@@.
@..@.....@@@..@@@...
15
16 1 0
17 13 0
16 3 0
8 9 0
3 16 0
18 12 1
6 4 1
17 19 1
6 6 1
9 2 1
7 19 2
10 7 2
11 9 2
7 7 2
16 10 2

15 2 0
5 5 0
0 12 0
2 9 0
4 8 0
3 12 1
16 6 1
8 0 1
19 6 1
7 12 1
12 3 2
9 16 2
11 8 2
9 17 2
18 15 2
