width 20
height 20
.@.@@@@@@@@@@@@@@@@@
...@@@@@@@@@@@@@@@@@
@@..@@@@@@@@@@@@@@@@
@..@@@@@@@@@@@@@@@@@
.@.@.@@@@@@@@@@@@@@@
.....@@@@@@@@@@@@@@@
.@@@..@@@@@@@@@@@@@@
...@@.@@@@@@@@@@@@@@
.@@..@@@@@@@@@@@@@@@
..@.@.@@@@@@@@@@@@@@
@.....@@@@@@@@@@@@@@
.@.@@..@@@@@@@@@@@@@
..@.@.@.@@@@@@@@@@@@
@........@@@@@@@@@@@
@.@.@.@.@.@.@@@@@@@@
...@@@.......@@@@@@@
@.@@@@@.@.@.@@@@@@@@
@@@@@@.@.@@..@@@@@@@
@@@.@.......@@@@@@@@
@@....@.@.@@@@@@@@@@
15
11 18 0
1 3 0
4 6 0
11 17 0
9 16 0
8 15 1
2 7 1
2 15 1
2 11 1
2 10 1
5 19 2
1 16 2
0 1 2
0 4 2
3 9 2

5 7 0
11 18 0
10 18 0
7 14 0
9 16 0
2 13 1
1 10 1
0 8 1
3 5 1
7 19 1
5 11 2
3 19 2
4 5 2
2 19 2
8 17 2
