width 20
height 20
@@@.@@@.@.......@...
@@...@....@@.@.@.@.@
@@@.@.@.@@.@@.......
............@@.@@.@.
@@.@.@.@.@.@.@@..@@.
....@.@@@.......@.@.
.@@...@@@@.@@.@@....
@...@@.@@@@....@@.@@
@@.@....@@@@.@.@....
@@@.@.@@.@@.@.@@.@@.
@.@................@
....@.@@.@@.@@.@.@.@
@@@.@@...@.@@@.@@...
.....@@.@@.@@@.@@@.@
@.@.@.@@@...@...@@@@
@@.....@..@.@@.@@@@@
@@@@@@.@.@.@....@@@@
@@@@@@@......@.@@@@@
@@@@@@@.@.@.@@@@@@@@
@@@@@@@..@@..@@@@@@@
15
12 8 0
15 2 0
11 17 0
12 7 0
15 4 0
17 7 1
12 4 1
3 13 1
5 3 1
6 10 1
11 15 2
14 10 2
15 16 2
11 10 2
2 4 2

3 7 0
1 10 0
10 0 0
8 16 0
7 17 0
8 10 1
6 3 1
12 19 1
12 16 1
13 6 1
14 0 2
12 5 2
3 11 2
9 1 2
5 6 2
