width 20
height 20
@@@@........@.@@@.@@
@@@@@.@.@.@....@..@@
@@@@...@@@.@.@@@.@.@
@@@@@.@@@@.....@....
@@@@@..@@..@.@...@@.
@@@.@@@@@@..@@@.@.@@
@@@.@@..@.@.@..@@...
@@....@......@....@.
@.@.@@..@.@.@..@@..@
@......@.@...@.@.@.@
..@@@@@...@.@@@.....
@.@.....@.@@.@..@.@@
...@@.@..@@...@..@..
@.@.@@.@..@@.@.@.@.@
.........@..........
@.@.@.@@..@.@@@@.@.@
..@@..@@.@....@.@@..
@..@@.@@@@@.@...@..@
@.@@.@.@.@.@..@..@..
.............@..@@@.
15
12 9 0
5 9 0
10 0 0
11 16 0
11 9 0
3 11 1
8 19 1
11 6 1
17 1 1
11 12 1
6 2 2
8 15 2
3 19 2
6 8 2
8 12 2

13 17 0
4 0 0
3 9 0
6 11 0
12 3 0
7 8 1
8 19 1
11 7 1
19 3 1
17 6 1
12 19 2
1 18 2
6 4 2
13 12 2
19 7 2
