width 20
height 20
..@@@.....@..@@.....
.@.@.@.@.@.@..@@.@.@
........@@.@.@.@..@@
@@.@.@.@@........@@@
....@@@@.@.@.@.@.@@@
@@.@.@.@.@..@...@@@@
...........@.@.@@@@@
@@.@.@@.@@.@..@@@@@@
....@@@@.@@..@@@@@@@
@@@..@....@.@@.@@@@@
@..@..@.@@......@@@@
.@.@.@@.@.@@.@.@@@@@
...........@@...@@@@
@@.@.@.@.@.@.@.@@@@@
.@@@..@.@@.....@@@@@
..@..@.....@@.@.@.@@
@.@@..@.@@..@......@
.....@.@@..@@.@.@.@@
@.@.@...@@..@..@....
@@....@.@@@@..@@@.@.
15
1 16 0
2 19 0
6 5 0
11 3 0
12 1 0
10 5 1
12 2 1
1 2 1
6 2 1
19 0 1
3 18 2
0 17 2
6 15 2
2 4 2
3 4 2

11 10 0
13 1 0
2 8 0
0 14 0
4 15 0
10 16 1
12 2 1
9 6 1
2 13 1
10 3 1
14 3 2
13 19 2
19 0 2
4 19 2
9 0 2
