width 20
height 20
@.@@@.@.@.@@@.@.@@.@
...@................
@.@.@.@.@.@.@.@.@.@.
......@@...@@@..@.@.
.@.@.@@.@.@@@..@.@@@
@..@@......@@@......
..@...@@@.@@@@.@.@@.
@..@@....@.@@@@...@@
.@@...@.@..@.@..@.@.
.@..@@@@.@....@@....
...@@@@....@.@..@.@@
.@..@@@@.@@.@.@...@@
.@@..@..........@.@@
@...@@@.@.@.@.@..@@@
..@..@...@.@.@.@@.@@
@..@@..@.@.........@
@.@@@@@...@@.@@.@.@@
...@@@@@.@@.@@.@....
@.@@@@@@.........@.@
@@@@@@@@.@.@.@@.@@.@
15
19 6 0
1 2 0
2 10 0
4 6 0
16 9 0
18 0 1
12 12 1
12 18 1
0 17 1
6 12 1
17 1 2
8 10 2
4 8 2
1 5 2
15 1 2

9 10 0
1 3 0
14 3 0
16 4 0
13 4 0
17 17 1
14 6 1
10 15 1
15 7 1
2 13 1
7 13 2
15 15 2
10 19 2
0 11 2
2 17 2
