width 20
height 20
@@@@......@@@@@@@.@.
@@...@.@.@@@@@@@....
@.@@..@.@@@@@@@..@@.
.....@@...@@@@@@@...
@.@.@@@@.@@@@@@@..@.
..@@@@....@@@.@..@@.
.@@@@@@@.@.@....@...
...@@@@@.....@.@@@.@
@.@@@@@.@.@@..@@@...
...@@....@@@.@@@.@.@
@.@...@@..@...@.....
...@@.@.@@.@.@.@.@.@
@.@.....@@.@.@....@@
....@.@.@....@@.@@.@
.@@.@@.@.@.@.@..@...
...@.....@..@@.@..@.
.@..@.@.@@@.@...@.@.
@.@.@@...@.@.@.@...@
....@.@@.......@@.@@
@.@......@.@.@......
15
4 15 0
3 12 0
1 19 0
8 1 0
6 15 0
16 1 1
7 16 1
4 12 1
13 6 1
1 4 1
9 3 2
18 17 2
8 18 2
17 14 2
11 16 2

7 2 0
9 18 0
10 15 0
17 8 0
6 17 0
15 2 1
4 10 1
1 7 1
13 10 1
3 12 1
6 12 2
19 8 2
1 11 2
10 19 2
1 15 2
