width 20
height 20
@..@.......@@@@@@@@@
..@@@.@.@.@@@@@@@@@@
.@.@.@@@...@..@@@@.@
......@..@@..@.@@..@
@.@@@.@.@@.@.....@.@
@.@..........@@@@..@
...@.@.@@.@@.@..@@..
@.@...@@@@@.@..@.@.@
.@.@.@.@@@@..@......
........@@..@.@.@.@@
.@@@.@.@@.@......@@@
@.@.@.......@.@.@.@.
.....@.@.@.@.@......
@.@.@@..@.....@.@.@@
@.@@.@.@.@@.@@.@....
..........@.....@.@.
.@.@.@.@.@.@.@.@.@..
..@@@@@.@@.@@.....@.
.@.@.@.......@.@.@..
.......@.@.@..@...@.
15
19 17 0
15 13 0
18 18 0
0 19 0
4 6 0
9 2 1
0 17 1
6 6 1
8 0 1
15 12 1
10 9 2
3 11 2
1 15 2
14 18 2
7 0 2

15 10 0
11 8 0
6 8 0
6 18 0
16 10 0
0 15 1
18 3 1
6 6 1
9 2 1
18 12 1
10 9 2
4 3 2
6 12 2
11 14 2
19 16 2
