width 20
height 20
..@.@@@@@@@....@.@@@
@....@@@@@@@.@....@@
..@.@.@@@@@@@@.@.@@@
@..@....@@@@.@@@.@@@
..@..@.@@@@....@.@@@
@...@.@.@@.@.@....@.
..@..........@@.@.@.
@..@.@.@.@@@.@@@....
..@@@.@@@@..@.@.@.@.
@.....@@.@.@@....@..
..@.@.........@.@@@.
@@..@.@@@.@.@.@..@@.
...@@..@@@.@@@..@@.@
@.@.@.@@@...@.@.@...
@@...@@@@.@.......@@
@@@.@.@...@@.@.@@.@.
@@@.@...@...@.@...@.
@@....@.@.@...@@@...
@@@.@.@@@@..@@....@.
@@...@@@@@@...@@.@..
15
0 12 0
5 6 0
16 1 0
16 7 0
2 3 0
4 17 1
16 3 1
11 17 1
19 6 1
3 1 1
6 3 2
5 9 2
12 4 2
6 4 2
9 14 2

4 19 0
9 16 0
4 14 0
9 15 0
1 12 0
12 4 1
5 10 1
14 4 1
17 14 1
13 0 1
3 4 2
16 16 2
15 9 2
2 1 2
1 13 2
