width 20
height 20
.@@@.@@..@@.@..@@...
.@@@.@@.@...@.@.@@@.
..@...@..@@.@.......
.@.@@...@.@...@.@.@.
......@.....@@.@..@@
.@.@@..@@.@....@@.@.
..@...@....@.@.@@@..
.@.@@@@@@.@@@...@.@.
.@....@.@..@..@@....
@@@@.@....@@@...@@.@
@@@....@.@@@.@.@@@..
@@@@.@.@..@......@.@
@@....@..@@@.@.@@..@
@.@.@@.@..@@..@@..@.
..@@.....@...@@@@...
@....@.@.@.@......@.
@.@@.@@.@.@.@@.@.@..
....@.@.@.@.@...@@@.
@.@..........@@@@@..
@@..@@@.@.@.@@@@@@@.
15
4 8 0
14 6 0
3 6 0
12 8 0
0 2 0
5 18 1
19 15 1
11 3 1
8 9 1
15 7 1
6 14 2
19 18 2
5 10 2
15 17 2
18 11 2

9 19 0
13 3 0
4 6 0
12 18 0
5 4 0
18 8 1
12 5 1
15 11 1
9 4 1
14 9 1
0 4 2
11 19 2
8 0 2
5 17 2
4 18 2
