width 20
height 20
.@@@.@@@@.@.@.@@@@.@
..@...@@......@@@...
.@.@.@..@.@.@..@.@.@
.......@.@@@..@.....
.@@.@@...@..@.@.@.@.
.@.@@..@..@.....@@..
@.....@@@...@@.@@@@.
@@.@.@@@@.@.@@..@@..
@..@@.@@...@...@@.@@
.@..@...@.@@@@@@....
.@.@@.@@.@.@.@@.@.@@
...@..............@.
@@.@.@.@.@@@.@@.@.@.
.....@@.@.@..@@..@..
@.@@.......@.@..@.@.
@..@@@.@@@@.@.@.@...
..@.@.@@.@@.....@.@.
.@..........@.@....@
.@@.@.@.@.@@.@.@@.@@
.@...@@@..@.........
15
0 3 0
0 1 0
6 4 0
15 15 0
14 2 0
12 16 1
17 16 1
18 15 1
1 3 1
5 1 1
11 2 2
10 4 2
13 16 2
13 1 2
6 3 2

8 4 0
0 16 0
0 19 0
6 3 0
4 6 0
8 16 1
12 18 1
17 12 1
11 15 1
14 16 1
10 1 2
9 7 2
2 5 2
3 17 2
6 17 2
