width 20
height 20
.@@..@@@@@@@@@@@.@@.
....@@@@@@@@@@@.....
@@.@.@@@.@@@@@@@@.@.
..........@@@@...@@.
@.@@.@.@.@.@.@@.@.@.
....@@@.............
@.@.@@@@.@.@@@.@.@.@
@@..@@@@@..@@.@@@...
@@@.@@@@@.@.@..@.@@.
@@@@@@@@@.....@..@@@
@@@@@@@@@@@.@@.@..@@
@@@@@@@@@@@......@.@
@@@@@@@@@@@@@@.@....
@@@@@@@@@@@@@@@.@@.@
@@@@@@@@@@@@@@@.....
@@@@@@@@@@@@@@..@@.@
@@@@@@@@@@@@@@@.@..@
@@@@@@@@@@@@@@@@..@@
@@@@@@@@@@@@@@@@@.@@
@@@@@@@@@@@@@@@@@@@@
15
6 3 0
1 4 0
19 2 0
15 1 0
13 11 0
10 5 1
19 4 1
4 3 1
17 12 1
9 7 1
17 14 2
16 3 2
15 4 2
3 0 2
16 8 2

16 10 0
18 16 0
17 16 0
12 9 0
14 11 0
18 1 1
18 15 1
19 14 1
10 5 1
11 5 1
3 8 2
9 3 2
8 3 2
16 12 2
8 5 2
