width 20
height 20
.@.@@@..............
...@@@@@.@@@@@.@@@@.
.@...@@@@..@@.@.@.@.
@..@@.@@.@..........
@@.........@.@.@@.@.
@..@.@.@.@@.@@@@@@..
.@.@@@@@....@..@.@.@
...@.@.@.@.@@.@..@..
.@.@...@.@@....@..@@
.@@..@.....@.@...@..
@@.@.@@.@.@.@@.@@@.@
.......@@...........
.@.@@.@@@@@@.@.@@.@.
@@..@@@@@@..@@@.@.@@
.@.@.@@@@..@.@.....@
.....@.@.@....@.@.@@
.@.@.....@@.@....@@@
..@@@.@@.@..@.@@@@@@
.@@@..@.@.@..@@@@@@@
..@..@......@@@@@@@@
15
1 7 0
2 12 0
17 0 0
3 19 0
8 7 0
17 15 1
17 12 1
18 10 1
7 19 1
15 15 1
7 16 2
12 18 2
14 1 2
4 8 2
9 2 2

1 3 0
14 0 0
10 3 0
9 0 0
3 2 0
15 3 1
14 11 1
17 0 1
13 15 1
6 16 1
18 7 2
2 6 2
10 4 2
0 17 2
6 7 2
