width 20
height 20
..@@@...........@.@.
@.@@..@.@@@.@.@.....
@.@.@.@@...@@@@@.@.@
......@@@.@.@.@.@...
@.@@@..@..........@.
...@..@@@@.@.@@.@.@@
.@..@@.@..@@@@...@..
..@......@.@.@@.@..@
.@.@.@.@......@@.@..
.@.@@@@@@@.@.@.@...@
.....@.@.@@@.....@..
@.@@........@.@.@..@
@@.@.@@.@.@..@...@..
.@.@@@...@..@@@@@@.@
....@@@.@@@.@@......
.@.@.@...@.@.@@.@.@.
@......@.@.......@@@
@@@.@.@..@.@.@.@..@@
.....@@@..@..@.@.@@@
.@.@..@@.@..@@@..@@@
15
2 6 0
10 17 0
2 16 0
11 4 0
9 12 0
13 8 1
8 19 1
1 3 1
1 18 1
18 3 1
8 10 2
7 15 2
19 1 2
9 18 2
0 7 2

6 8 0
12 16 0
15 1 0
11 19 0
16 10 0
3 6 1
9 3 1
8 16 1
7 0 1
11 3 1
18 6 2
1 7 2
4 7 2
1 2 2
14 17 2
