width 20
height 20
@...........@@@@@@@@
.@.@@@.@.@.@.@@.@.@@
....@..@@..........@
@@.@..@..@.@.@@.@.@.
@.@.@...@@@@.@.@....
....@.@@.@..@@..@@@.
@@@........@...@....
...@@@.@.@@..@@.@.@@
.@..@@@..@.@.@@...@@
..@@...@......@@@...
.@...@.@.@.@.@..@.@.
..@@.@..@.@..@@...@.
.@@@@@@.....@.@.@@.@
..@@.@@.@.@.@.......
.@.@.@.@@..@..@.@@.@
.......@.@@..@@@@@@@
@@.@.@......@@@@@@@@
@@@.@..@.@.@@@@@@@@@
@@....@.@@..@@@@@@@@
@@@.@@.....@@@@@@@@@
15
12 10 0
0 7 0
5 5 0
8 8 0
18 4 0
6 4 1
15 5 1
8 15 1
2 8 1
9 11 1
7 11 2
12 9 2
2 5 2
11 5 2
9 19 2

12 8 0
14 5 0
10 14 0
13 13 0
0 10 0
1 13 1
4 13 1
17 11 1
0 5 1
0 2 1
2 8 2
9 19 2
0 14 2
3 19 2
4 0 2
