width 20
height 20
.........@..@@@@@@@@
.@.@@.@@...@@@@@@@@@
.@@...@.@.@@@@@@@@@@
@@@.@@@....@@@@@@@@@
.@.@@.@.@@..@@@@@@@@
.........@.@@@@@@@@@
.@@.@.@.@..@@@@@@@@@
...@...@..@@@@.@@@@@
@.@.@.@@@..@@...@@@@
....@.@@.@@.@@.@.@@@
@.@.@@............@@
@@..@@@.@.@.@.@.@..@
...@@....@.@@@@.@.@@
.@....@@.......@..@@
..@.@.@@@.@.@.@@@.@@
.@.@.@@@@.@@...@@.@@
.....@@@@...@.@@@@@@
.@.@@@@@@@.@.@@@@@@@
@..@@@@@@.....@.@@@@
@@.@@@@@@@.@@.....@@
15
7 11 0
7 10 0
10 4 0
10 0 0
13 16 0
1 5 1
6 7 1
9 7 1
7 4 1
0 9 1
10 8 2
14 10 2
6 10 2
9 11 2
9 2 2

0 2 0
6 5 0
10 4 0
5 7 0
16 19 0
9 16 1
1 10 1
3 14 1
7 4 1
9 7 1
0 15 2
14 9 2
17 11 2
13 14 2
11 4 2
