width 20
height 20
@@@.....@@@@..@.@@@.
@@..@.@@....@.@.@@..
@.@.@@@.@.@.....@@@.
...........@.@@..@..
@.@.@.@.@.@@@@@@..@.
@..@@@.@.@.@.@@.@.@.
..@@@@..............
@.@@@..@.@.@@.@.@.@.
@@.@@@.@.@@@.@.@..@@
@...@@..@.@......@.@
.@.@.@.@..@@.@.@....
.........@@.@@..@.@.
@.@@.@.@.@..@..@@@..
@@....@...@..@.@@@@@
@@@@.@.@.@.@...@..@@
.@@@@..@....@@@.@.@.
.@.@..@.@@.@.@......
.....@........@.@@@.
.@.@@.@.@.@.@.@@@...
@........@..@.....@.
15
1 5 0
8 17 0
19 18 0
15 19 0
10 1 0
16 10 1
7 13 1
16 16 1
4 19 1
11 2 1
11 19 2
18 10 2
16 19 2
12 3 2
10 16 2

2 16 0
12 13 0
9 6 0
15 3 0
9 1 0
12 3 1
5 15 1
4 19 1
2 8 1
11 2 1
10 17 2
13 7 2
17 16 2
3 19 2
17 15 2
