width 20
height 20
@@@@@@...@.@.@.@..@@
@@@.@.@@.....@.@.@.@
.@......@@.@...@....
..@.@.@.....@@@.@.@.
.@@@..@.@.@.@.@....@
..@@@.@..@@@....@.@@
.@.@.@..@.@..@@..@.@
.....@@...@@...@.@..
@@.@@.@.@....@@.@..@
@........@@.@.@.@@.@
@.@.@.@.@@..@.......
@@@@@.@@@.@...@.@.@.
@@@@....@..@.@.@@@..
@@@@@.@...@@@....@@.
@@@@@@..@...@.@.@.@.
@@@@@@.@..@..@......
@@@@@@..@@..@.@@@.@.
@@@@@..@@@@.@..@@@..
@@@@@@..@@@...@@@.@.
@@@@@@@@@@@@.@@@....
15
8 13 0
14 13 0
9 3 0
10 8 0
16 2 0
18 1 1
7 2 1
6 6 1
19 17 1
10 3 1
15 9 2
19 10 2
19 12 2
19 3 2
11 15 2

8 9 0
18 17 0
10 1 0
14 13 0
9 7 0
13 16 1
17 16 1
5 12 1
6 6 1
13 17 1
18 10 2
14 17 2
9 14 2
19 3 2
6 15 2
