width 20
height 20
@.@.....@@....@...@@
....@@.@.@@@.@.@.@@@
.@.@......@@......@@
.@@.@.@.@....@@.@.@@
@.@..@@@.@@@...@.@@@
@.@.@.@....@@@...@@@
......@.@.@.@.@.@@@@
@.@.@.@.@.......@@@@
...@.....@@.@.@..@@@
@.@@@@@.@....@.@..@@
...@@@@@@@@@@@.@.@.@
@.@.................
@@.@.@@@@@@.@.@.@.@.
@@......@@.@.@.@@@@.
@@.@.@.@........@..@
@@@.@@..@@.@.@.@.@.@
@@...@@.@.@@@.......
@@@@.......@.@.@.@.@
@@.@.@.@.@......@@@@
......@@@..@.@.@@@@@
15
3 19 0
14 19 0
2 14 0
16 15 0
12 0 0
10 11 1
18 16 1
14 14 1
12 1 1
11 7 1
14 9 2
8 5 2
16 8 2
14 2 2
11 3 2

16 11 0
3 11 0
15 7 0
5 11 0
4 8 0
1 1 1
9 19 1
2 16 1
5 17 1
10 19 1
15 6 2
13 6 2
7 16 2
10 7 2
6 15 2
