width 20
height 20
...@@@@@@@@....@@.@.
.@..@@@@@@@@.@......
@@@..@.@@@@.@..@.@.@
@@..@@..@@@..@..@@@@
@.@..@.@.@.@...@.@@@
...@.........@@...@@
@.@.@.@.@.@@.@.@.@.@
......@@@@@@........
.@.@@...@...@.@.@@.@
@....@.@@@.@@@@@@@@@
@@@.@.@@@..@..@.@@.@
@.......@.@.@...@...
..@.@.@.....@.@..@@.
.@.@.@@.@.@....@@...
@.....@@@@@.@.@.@.@.
@@.@@.@@.@@@.......@
....@.@...@.@@@.@.@.
@@.@@@.@.@.....@@...
...........@.@.@.@.@
@@@@.@.@.@..@......@
15
16 6 0
16 5 0
15 12 0
16 1 0
7 3 0
7 11 1
0 7 1
5 10 1
10 4 1
16 19 1
9 10 2
18 2 2
10 9 2
7 13 2
16 2 2

2 1 0
12 18 0
16 12 0
11 16 0
15 8 0
4 19 1
13 2 1
1 11 1
19 12 1
7 3 1
17 15 2
16 18 2
13 4 2
4 18 2
14 19 2
