width 20
height 20
.@@@.@@@@...@@..@.@.
.....@.@.@.@@.@...@.
.@.@..........@.@@..
@@@..@.@@.@.@.....@.
@@@.@.@@@@@@@.@.@...
@@....@@@@@..@.@.@.@
@@@.@..@.@.@.@......
@@.@.@.@...@...@.@.@
@........@.@.@..@@@@
..@.@.@.@.@@..@.@..@
@..@@@.@.....@@..@..
.@.@.@.@.@.@..@.@@.@
........@@@..@.@.@.@
@@.@.@.@.@@@........
@.@.@@....@.@.@@.@.@
.......@.@@...@.@@..
@.@@.@@..@@@@@.....@
@@.....@.@.@@@.@.@..
@.@.@.@@....@...@..@
.....@@..@.@@@.@@.@@
15
2 13 0
3 8 0
11 5 0
10 1 0
13 2 0
7 14 1
12 6 1
11 0 1
13 4 1
14 5 1
11 14 2
14 18 2
0 2 2
14 0 2
13 9 2

18 13 0
15 3 0
19 2 0
12 6 0
10 8 0
4 12 1
0 0 1
4 16 1
16 12 1
7 12 1
19 1 2
4 17 2
14 6 2
15 18 2
12 7 2
