width 20
height 20
.@.@.....@@.@.@@...@
....@.@.@@..@..@@.@.
@.@....@@@.@@@..@...
@@.@.@..@...@@.@..@.
....@..@.@.@@..@.@..
@@.@.@......@.@.@.@.
@......@@.@.@.......
..@.@@.@.@@@@.@@.@@@
@@.@.......@..@@@@@@
....@.@.@.@..@@@@@@@
@.@...@@..@.@.@@@@@@
...@.@@@.@@....@@@@@
.@..@....@..@.@@@@@@
@..@..@@.@@..@.@@@@@
..@@@@.@@.@.@..@@@@@
.@.@.@........@@@@@@
.......@.@.@.@@@@@@@
.@.@@@..@@@@@@@@@@@@
..@@@@@@@@@@@@@@@@@@
.@@@@@@@@@@@@@@@@@@@
15
1 4 0
6 16 0
13 10 0
0 16 0
4 3 0
13 14 1
6 6 1
5 9 1
0 19 1
16 7 1
4 13 2
2 11 2
0 11 2
5 6 2
7 5 2

17 2 0
0 1 0
12 8 0
2 4 0
0 18 0
3 12 1
13 8 1
12 11 1
0 14 1
19 5 1
12 13 2
5 6 2
1 16 2
4 13 2
18 6 2
