width 20
height 20
@@@@.@.@.@.@@@@@...@
@@@....@....@@@@@.@.
@@@.@@.@.@.@@.@@@...
@@@@.....@@....@@@@.
@@@@.@.@...@.@..@.@.
@@@@.@@.@.@@.@.@..@.
@@@.@@....@...@.@.@.
@@@....@.@@@.@......
@...@@@@@@@...@.@@@@
@@.@@@@@@..@.@...@.@
@...@..@.@...@@.@...
.@.@.@.....@.@...@@.
......@.@.@.@.@@....
.@.@.@.@.........@.@
@..@.....@.@@.@@@...
..@@.@.@..@@..@@@@.@
@...@.@@@.@.@..@@.@@
..@@@.@@..@.@@....@@
.@......@...@@@.@.@@
...@.@.@..@..@@@...@
15
6 6 0
12 3 0
14 11 0
7 6 0
12 9 0
15 8 1
19 11 1
8 7 1
1 15 1
11 3 1
6 10 2
4 11 2
18 13 2
18 7 2
8 13 2

17 7 0
12 8 0
4 18 0
0 15 0
19 10 0
8 2 1
6 2 1
10 2 1
19 11 1
9 11 1
10 1 2
10 14 2
17 5 2
6 4 2
1 10 2
