width 20
height 20
@@@@@@@.@@.@....@@@@
@@@@@@@......@.@..@@
@@@@@@.@.@.@..@..@.@
@@@@@....@.@.@..@...
@@@@..@@.@@..@.@.@.@
@@@@@..@@..@.@......
@.@@..@@@@.....@.@@@
..@.@..@@@@@.@.@@.@@
@.@...@.@@@@@.......
....@....@@@.@.@.@.@
@.@..@@.@@@.....@@@@
@@@@.@.@.@..@.@.@.@@
.@@@@......@@@@@@..@
..@@@@.@@.@@..@.@.@.
.@.@@@.@.@@.@.....@.
..............@.@...
@@.@.@.@.@.@.@@@@@@.
....@...@@@@@.@.@...
.@.@@@.@@@@@......@.
..@@@@@@@@@@.@@.@.@.
15
6 2 0
10 12 0
12 16 0
12 2 0
18 8 0
10 3 1
4 8 1
6 11 1
3 8 1
1 8 1
19 13 2
12 6 2
5 9 2
19 18 2
14 0 2

10 15 0
0 17 0
16 9 0
6 16 0
1 6 0
19 16 1
12 6 1
6 2 1
12 19 1
8 1 1
7 0 2
17 18 2
6 15 2
19 17 2
0 7 2
