width 20
height 20
@@@@@....@@@@@.@.@..
@@@@@.@.@.@@.......@
@@@@@@.......@.@.@..
@@@@@@@.@.@@.@@..@.@
@@@@@@@.@@...@@.@...
@@@@@@.@...@...@.@.@
@@@@@...@.@.@.@.....
@@...@.@@....@@@.@.@
@@.@@...@.@@.@@..@.@
@@.@@@.@@@.@@@.@..@@
@@...@..@@.......@.@
@@.@@@.@.@.@.@.@....
@@..@.......@.@@.@.@
@@.@.@.@.@@@....@...
@.......@....@.@.@@.
..@@@@.@.@.@@.......
@.@.@....@@...@.@@@.
.....@@.@@@@@@....@@
@.@@...@.@@@@@@.@...
@.@@.@....@@@@@@..@@
15
18 2 0
15 15 0
15 4 0
5 6 0
8 15 0
2 11 1
5 14 1
10 14 1
14 5 1
13 16 1
6 7 2
11 14 2
3 7 2
6 11 2
7 2 2

9 6 0
12 11 0
9 8 0
11 12 0
19 13 0
6 16 1
2 10 1
8 13 1
6 8 1
10 14 1
14 5 2
18 0 2
10 5 2
5 18 2
4 18 2
