width 20
height 20
@@.@.@.@@..@@@.....@
...@...@.@..@.@.@.@@
.@...@.....@..@@...@
..@@.@@@.@@@@..@.@..
.@@.@.@.@@@@@@...@.@
........@.@@...@@@..
@.@@@.@...@@.@@....@
.....@.@@.....@.@.@.
@.@@@.....@.@.@.@...
@@.@.@.@.@@@@@...@.@
@@.@.@.@....@@@.@@@@
........@.@.@@@@.@@@
.@.@.@@..@....@....@
..@.@@..@@@@.@@@.@.@
@@@.@.@.@@@.@@@@@...
.............@.@.@.@
@.@.@.@.@.@@@.......
..@@.@...@@..@.@.@.@
@....@.@@@.@...@@...
..@.@@.......@.@..@.
15
18 16 0
4 12 0
14 16 0
11 12 0
0 1 0
6 9 1
1 3 1
19 7 1
10 7 1
19 19 1
10 1 2
16 9 2
8 17 2
18 5 2
2 7 2

16 13 0
4 5 0
17 6 0
11 11 0
16 16 0
5 6 1
0 3 1
13 8 1
14 15 1
12 17 1
4 10 2
18 16 2
15 4 2
13 7 2
3 11 2
