width 20
height 20
@@@......@@@@@@@...@
@@@@@.@.@.@@@@@..@.@
@@@@@@.....@.@@@..@@
@@@@@@@.@.@@...@.@@@
@@@@@..@...@.@@...@@
.@...@..@.@...@@.@@@
.@.@..@.....@.@...@@
....@...@.@@.@.@@..@
@@.@..@@.@........@.
....@......@.@.@@...
.@@..@@@.@.@..@@..@.
@...@.....@@@..@@..@
@@.@..@.@@@@@.@@@.@@
@@@@@..@@..@@@@@@..@
@@@@..@.@.@.@.@...@@
@@@@@@........@@@.@@
@@@.@..@.@.@@.......
@@....@.@.@...@.@.@@
@@@.@.....@@.@@..@@@
@@...@.@.@@@@@@.@@@@
15
15 4 0
12 17 0
13 5 0
11 15 0
18 13 0
0 9 1
8 19 1
6 18 1
0 6 1
1 9 1
17 2 2
10 9 2
8 11 2
17 6 2
9 5 2

17 0 0
17 14 0
13 5 0
12 10 0
16 4 0
9 15 1
10 9 1
14 16 1
3 19 1
6 5 1
14 8 2
5 1 2
13 17 2
7 2 2
8 15 2
