width 20
height 20
@....@@..@....@@@...
@.@.@.@.@.@@@.@...@@
@@..@.....@.@...@...
@@@...@.@...@.@..@.@
@@.@.@.@..@...@.@@@@
...@.@..@@..@@@@@@@@
.@..@..@.@.@.@@@@@@@
@@.@.@...@.....@@@@@
@......@...@@.@.@.@@
.@.@@@.@@@...@@...@@
......@..@.@.@..@@@.
.@.@.@.@..@.@.@.@@..
..@@.....@........@.
@.@@.@.@.@@.@.@.@.@.
@..@@@@..@...@@@..@.
..@@@@@@..@.@.@..@..
@.@@@@@@@.@....@.@@.
@@@@@@@@@.@.@@..@...
@@@@@@.@@.@@.@.@.@@.
@@@@@...............
15
19 17 0
11 16 0
9 17 0
12 10 0
2 10 0
3 2 1
7 19 1
2 11 1
13 1 1
10 3 1
8 0 2
16 14 2
6 18 2
12 16 2
19 16 2

11 3 0
2 11 0
1 1 0
11 15 0
9 4 0
2 9 1
6 18 1
10 5 1
9 16 1
13 13 1
14 19 2
19 19 2
4 7 2
4 11 2
4 3 2
