width 20
height 20
.@@.@.@.@@...@...@..
.@........@.@.@.@.@.
..@@@@.@.@..........
@..@@...@@@@@.@.@.@.
.@..@@.@.@.....@@@..
..@.@....@@@@.@.@.@.
@....@@@..@.@@......
@.@@@@...@.....@.@.@
@.@@..@.@.@.@.@@@@..
..@@@......@@@...@.@
@..@..@@.@.@..@@.@..
..@.@.@.@.@..@.@...@
@...........@@...@..
..@.@.@@@.@.@@.@..@@
@.@@.....@......@@.@
....@.@.@.@@.@.@....
@.@@..@....@@.@.@@.@
...@@.@.@.@@........
.@.@..@@.....@.@.@@.
..@..@@@@.@.@..@...@
15
19 5 0
13 2 0
5 5 0
1 12 0
9 6 0
19 2 1
14 15 1
19 10 1
5 16 1
13 3 1
0 11 2
1 19 2
3 15 2
16 12 2
1 5 2

12 14 0
15 16 0
6 3 0
7 1 0
6 9 0
0 9 1
13 14 1
18 12 1
5 1 1
11 11 1
17 5 2
7 9 2
14 13 2
1 12 2
13 8 2
