width 20
height 20
@@@@@@..@@.@...@.@.@
@@@@@@@..@...@......
@@@@@@..@.@@@.@.@.@.
@@@@@..@...@@....@..
..@@@@.@.@....@.@@@.
@..@......@.@..@.@.@
..@.@.@.@@@@.@.@....
.@.....@@.@......@.@
..@.@.@@..@@@@.@..@@
@...@@..@.@.@.@..@@@
@@.@..@........@..@@
@.@..@..@.@.@.@@@.@@
..@@...@@.@@..@@..@@
@..@@@@@.@.@@.@.@..@
@.@..............@..
..@.@.@@.@@.@.@.@..@
@.@.@@@@...@.@..@.@.
....@.@@.@@...@.....
@.@...@.....@..@@.@.
@..@.@@@.@@@@@...@..
15
0 15 0
9 2 0
13 4 0
8 16 0
15 14 0
16 9 1
19 1 1
1 11 1
14 10 1
0 8 1
15 17 2
13 10 2
12 10 2
14 5 2
6 11 2

16 7 0
13 14 0
13 12 0
7 10 0
5 6 0
4 11 1
16 10 1
3 17 1
12 4 1
11 4 1
17 17 2
18 7 2
13 3 2
1 4 2
1 15 2
