width 20
height 20
@@@.@.....@.@.@@@@@@
@@....@.@.@...@@@@@@
@.@.@..@@@.@.@.@.@@@
.....@.@@@........@.
@.@.@.@.@..@@.@@.@..
.@.......@.@.@.....@
.@@.@.@.@.....@.@.@@
...@@@@..@.@.@...@@@
.@@@@...@@@...@.@@@@
...@..@.@@@.@..@@@@@
.@.@@.@@.@.@.@.@@@@@
.@.@...@...@....@@@@
..@.@.@.@@...@.@@@@@
@.........@@..@..@.@
..@.@.@.@....@@@....
@..@@@..@.@.@@@..@.@
..@@@..@.@...@@@..@@
.@@@@.@..@@.@@@..@@@
@@@@..@@......@@.@@@
@@@@@...@.@.@.....@@
15
1 15 0
5 17 0
13 18 0
6 5 0
10 5 0
14 7 1
14 10 1
7 7 1
10 12 1
9 6 1
10 10 2
0 14 2
11 3 2
6 13 2
5 11 2

5 13 0
19 14 0
6 8 0
7 4 0
11 1 0
10 3 1
14 9 1
0 7 1
7 15 1
4 5 1
0 10 2
0 8 2
16 18 2
0 11 2
10 7 2
