width 20
height 20
.@.@@@@@@@@@@@...@.@
....@@@@@@@@@@@@.@.@
@@.@@@@@@@@@@.......
@@...@@@@@@@@@@.@.@@
@@.@..@@@@@@@.@..@@@
@...@@.@@@@@@...@@@@
@.@@....@@@@..@@@...
.....@.@@@@@.@.@.@.@
@.@.@...@@@.........
...@@@@.@@..@.@.@.@.
@.@.@@.@.@@.@.@@.@@.
.............@@.....
.@@@.@.@.@.@..@@@.@.
....@.@.@@@@.@..@..@
.@.@@.@..@@...@...@@
.@....@@.@.@@..@@.@.
@..@@........@.@.@..
@@@@@@.@.@@@.@....@.
@@@@@@@@@.....@.@...
@@@@@@....@@.@@@..@.
15
10 18 0
4 6 0
13 6 0
2 9 0
10 11 0
10 9 1
8 11 1
12 6 1
1 8 1
1 13 1
12 11 2
6 16 2
16 19 2
8 14 2
5 4 2

6 7 0
3 3 0
4 7 0
15 13 0
5 8 0
13 14 1
14 8 1
2 1 1
1 11 1
15 0 1
12 17 2
11 16 2
11 10 2
8 17 2
10 9 2
