width 20
height 20
@....@@@@@@@..@@.@@.
.@@.@.@@@@@..@@@..@.
.......@@@@@.....@@.
.@@@@@@.@@@.@@.@....
..@.@.@..@@.@.@@@.@.
.@.....@.@..@...@@..
...@.@....@...@@...@
.@..@.@@.@..@@.@.@@.
@@@@.......@........
.@@.@.@@.@..@.@.@.@.
........@.@..@@@.@@.
@.@@@.@@....@.@.....
.@@@@@@@@.@.@...@.@.
..@@@@@@...@..@.@@.@
.@.@@@@.@.@@@..@@@..
....@.....@@..@@@.@.
@@.@@@@.@@@@@.......
....@.....@..@.@@.@.
@.@@.@.@.@.@.....@..
.......@.....@.@.@@.
15
5 7 0
15 2 0
9 14 0
5 17 0
2 10 0
19 10 1
19 12 1
13 12 1
13 4 1
12 1 1
16 8 2
9 6 2
1 10 2
7 10 2
6 8 2

3 4 0
16 8 0
3 10 0
5 19 0
19 9 0
5 10 1
13 5 1
18 3 1
7 15 1
11 7 1
0 6 2
17 9 2
8 17 2
2 2 2
9 11 2
