width 20
height 20
@.......@.@@@@@@@..@
@@.@@.@....@@@@@..@@
..@@...@@.@.@.@.@.@@
@....@@@............
@.@.@@@@@.@.@.@.@.@.
...@@@@@@.@@.@@@.@..
@.@.@@@@@@@..@.....@
....@@@@@@.@...@.@..
@.@..@@@@...@@..@..@
..@.@@.@.@.@@@@@@.@.
@@.........@.@.@@@..
@@.@.@.@.@...@.@@.@.
..@.@...@..@........
@...@@.@@.@..@.@.@.@
@.@@.@...@.@@.@...@@
......@@@.......@@@@
@.@@.@.@.@.@.@.@.@@@
@@@@........@@...@@@
@@@@.@.@.@.@...@..@@
@@@@@...@@@@@@.@.@@@
15
1 5 0
18 10 0
11 8 0
5 2 0
10 12 0
2 5 1
3 9 1
17 8 1
1 4 1
12 13 1
15 6 2
1 12 2
15 12 2
7 0 2
12 7 2

17 3 0
1 13 0
5 12 0
4 11 0
4 2 0
18 13 1
11 13 1
10 9 1
11 2 1
18 8 1
18 3 2
19 5 2
9 3 2
4 10 2
14 19 2
