width 20
height 20
@@@@@@@@@@.@@.@.@@@@
@@@@@@@@.........@@@
@@@@@@@..@.@.@.@@@@@
@@@@@@@.@@@.@....@@@
@@@@@@....@..@.@.@..
@@@....@.@.@.@@.@@@.
@@..@.@..........@..
@@@..@@@@.@.@.@.@.@.
@@.@...@@..@@@......
.@..@@@.@.@@@@.@@.@.
.@.@.@....@@@.@.@.@.
.@.@..@.@.@@.......@
.....@.@@@@.@.@.@@@@
.@.@.@....@....@@..@
..@....@.@@.@.@@@.@.
.@@@.@@@.....@......
@@@.....@.@.@..@@.@.
@@@@.@.@.@...@.@@@..
@@@@@....@@.@.@.@.@.
@@@@@@.@@...........
15
13 3 0
16 1 0
8 15 0
3 12 0
2 12 0
7 18 1
19 15 1
11 18 1
16 11 1
2 8 1
14 9 2
5 16 2
13 11 2
19 10 2
8 13 2

9 13 0
18 8 0
19 7 0
6 18 0
13 0 0
15 8 1
9 9 1
14 1 1
5 14 1
4 10 1
14 16 2
11 1 2
8 15 2
11 15 2
14 2 2
