width 20
height 20
.........@@@@@@@@.@@
@.@.@@@@...@@@@.@.@@
...@.@.@.@@@@@..@..@
@.@@.....@@@@@@...@.
..@..@@.@@@@@.@.@...
@.@@..@@@@@@...@..@@
@@.@.@@.@@@@@.@@@.@.
@@....@.@@@@........
...@.@...@@@@.@@@.@.
@@..@@@.@.@@@@@@.@..
.@@..@.....@@@@..@@.
.@..@.@.@.@.@@.@....
..@.....@........@@.
.@.@.@.@@.@.@.@.@.@.
......@@.@..@..@....
@.@@.@.@.@.@..@@@.@.
@@........@@@@@@@@@.
...@.@.@.@@.@.@.@.@.
.@..@@@.........@...
..@.@@@@.@.@@.@..@.@
15
3 4 0
7 4 0
7 16 0
8 1 0
11 13 0
19 3 1
8 2 1
10 1 1
1 1 1
7 10 1
10 19 2
11 14 2
7 11 2
17 2 2
8 16 2

19 15 0
15 1 0
1 4 0
18 2 0
3 11 0
4 0 1
9 1 1
4 2 1
12 5 1
7 10 1
10 19 2
10 1 2
2 0 2
3 10 2
12 7 2
