width 20
height 20
.@.@.@@@.@.@....@...
.............@@@.@.@
.@.@.@.@.@.@.@@@....
@...@@@@@@@...@..@.@
.@@....@.@.@.@@@.@@@
....@.@@......@...@.
@.@.@.@..@@@@...@...
.@.@.@.@...@@@.@@.@.
........@.@.@@@.@@..
.@.@.@@@@....@....@.
..@.@.@..@@.@..@.@..
.@@....@....@.@...@.
...@@@...@.@.@.@.@..
.@.@@@.@.@.@.@.....@
..@.@@@...@....@.@..
@....@.@.@@@@@..@..@
..@@.....@@..@.@@@@@
@@...@@.@@.@.@....@@
.@.@...@.......@@.@@
....@@.@.@.@.@@....@
15
0 18 0
4 9 0
15 13 0
1 12 0
18 19 0
13 10 1
6 13 1
0 0 1
8 14 1
15 5 1
0 19 2
8 6 2
10 1 2
4 7 2
10 4 2

5 1 0
8 4 0
8 19 0
6 8 0
17 17 0
19 5 1
3 3 1
10 5 1
4 17 1
4 0 1
18 10 2
11 8 2
15 0 2
1 15 2
10 1 2
