width 20
height 20
@.@@..@...@.@.@.@...
....@..@.@.......@.@
@.@@.@.@...@.@.@....
........@@.@..@..@@@
.@.@.@.@....@@@@.@@@
@...@@@@@@.@@.@...@@
.@.@.@.@......@@.@@@
.........@.@@@@.@@@@
@.@.@.@.@..@@....@@@
@..@.@.@.@....@.@...
@@.....@..@.@.@...@.
@@@.@.@..@...@@.@@..
@@@@....@.@@@@..@.@.
@@@@.@.@@...@.@.@.@@
@@@@@.@@..@........@
@@@@..@@.@@.@@.@.@..
@@@@@.@...@@@...@..@
@@@@...@.@@.@@.@@@.@
@.@.@.@@.@.....@@@..
.........@.@.@....@@
15
16 4 0
11 9 0
6 2 0
3 3 0
6 4 0
19 9 1
13 10 1
9 13 1
10 2 1
16 3 1
7 8 2
7 19 2
11 1 2
3 10 2
12 18 2

9 8 0
18 9 0
5 18 0
6 4 0
10 7 0
19 10 1
10 9 1
14 12 1
8 15 1
11 18 1
15 9 2
4 6 2
8 4 2
19 0 2
13 9 2
