width 20
height 20
@..@@@..............
..@.@@@.@.@.@@.@.@.@
@....@@@@@...@@@@...
@@@.@.@.@.@@.@@@@@.@
@..............@@@@@
.@.@.@.@.@@.@.@@.@@@
....@@@..@@@@.@@..@@
.@.@.@.@@@.@@...@...
..@@...@.@.@.@@@..@@
.@.@.@.......@..@...
......@@.@.@...@..@@
.@.@.@.@@.@..@..@.@@
..@@......@.@.@.....
.@.@.@.@@.@@....@.@.
....@@@@.@.@@.@@@..@
.@@@.@.........@..@@
..@@.@@.@.@.@.@@@..@
.@.@.@.@...@..@@..@.
.......@@.@@@@...@..
@.@.@.@@@..@...@...@
15
10 14 0
1 19 0
7 3 0
8 17 0
5 12 0
1 16 1
9 17 1
8 4 1
13 14 1
1 10 1
10 7 2
2 13 2
14 9 2
3 19 2
17 17 2

6 4 0
4 8 0
16 0 0
8 17 0
8 14 0
11 0 1
17 2 1
2 4 1
1 16 1
18 1 1
10 9 2
0 9 2
14 7 2
12 15 2
17 7 2
