width 20
height 20
@....@.@@..@........
@@.@@....@...@@@.@.@
@@..@@.@@@@.@.@@@...
@@.@.@...@.....@.@.@
......@@.@@.@.@@....
@.@.@.....@.@@.@.@@.
...@..@.@@.@.......@
@.@@@.@@@...@.@@.@..
@.@@......@@....@@.@
@@...@@.@....@.@...@
@@@@.@.@.@.@..@..@..
.@..@.....@@.@@@..@.
..@..@.@@.....@..@.@
.@..@@@@@.@.@@.@....
...@.@.@.@@@.@...@.@
.@........@...@@@..@
@..@.@@@.@.@.@.@@@..
@@.@@@@..@.........@
@@@@@@@@...@.@.@@@..
@@@@@@@..@..@.....@.
15
1 5 0
7 1 0
7 15 0
13 3 0
4 0 0
13 2 1
16 6 1
17 9 1
16 10 1
5 1 1
19 11 2
17 4 2
17 6 2
11 1 2
11 5 2

3 0 0
19 7 0
11 17 0
13 2 0
9 12 0
5 7 1
16 0 1
1 6 1
4 0 1
1 0 1
7 19 2
6 1 2
19 5 2
8 8 2
14 5 2
