width 20
height 20
@@@@@.@@@....@..@@..
@@@@......@.@.@.@@.@
@@@@@.@.@@..........
@@@@@@..@@@.@@@.@.@.
@@@@@@@.@@....@@@@..
@@@@@.....@.@.@.@.@.
@@@@@@@.@@..@.@.....
@@@@.@.@@.@.@@@@@.@@
@@@@..........@.@@.@
@@@@@.@.@.@.@...@...
@@@@@@...@@@@@.@@@.@
@@@@@.@.@.@.@.@.@...
@@@@............@@.@
@@@..@.@@@.@@.@.@..@
@..@..@@..@..@...@.@
@.@.@@.@@...@.@@...@
.........@@.....@.@@
.@.@.@@@....@.@...@@
..@@@@.@@.@@...@.@@@
.@@@.......@@.@...@@
15
0 19 0
16 19 0
10 19 0
6 7 0
5 1 0
12 8 1
18 2 1
10 12 1
16 15 1
19 5 1
14 10 2
4 12 2
7 19 2
15 17 2
18 6 2

7 19 0
19 4 0
14 9 0
11 14 0
18 14 0
12 14 1
17 17 1
13 6 1
15 8 1
17 15 1
9 14 2
15 16 2
11 2 2
17 5 2
10 15 2
