width 20
height 20
....@.@...@@@....@..
.@.@...@@..@..@@.@.@
.@@.@.@..@...@...@..
........@@.@@.@.@@@.
@.@@.@@.@.@.@.@.....
@.@..@..@.......@@.@
.@.@@.@...@.@.@@...@
......@.@@@@...@@.@@
.@@.@....@@@@.@.@@@@
..@@@@.@...@......@@
.@.@@@@..@@@@.@.@...
....@..@...@.@@.@.@.
@@.@.@..@.@...@.@@..
@......@.@.@.@.@.@.@
.@.@.@.....@........
..@...@.@@.@.@@.@@.@
.@.@.@@@@.@....@@@.@
...........@.@..@..@
@.@@.@.@.@..@..@@@..
@@@@@...@..@@@...@.@
15
12 5 0
12 17 0
8 6 0
7 17 0
2 3 0
9 11 1
6 11 1
15 5 1
5 0 1
17 6 1
2 14 2
15 3 2
6 1 2
8 2 2
7 8 2

0 6 0
17 10 0
1 3 0
13 9 0
19 3 0
8 9 1
8 0 1
10 13 1
5 1 1
7 5 1
14 7 2
3 3 2
6 17 2
18 5 2
7 8 2
