width 20
height 20
@@@@@@@@@@..@.@@.@@@
@@@@@@@@..@......@@@
@@@@@@@@@.@.@.@@..@@
@@@@@@@@.....@@..@@@
@@@@@@@@@.@.@..@...@
@@@@@@@@@@...@...@@@
@@@@@@@@@..@.@.@@...
@@@@@@@@@@..@..@.@.@
@@@@@@@@@@@@.@......
@@@@@@@@@@.@...@@.@@
@@@@@@@@@@...@..@.@@
@@@@@@@@@..@@@@..@@@
@@@@@@@@@@...@.@@@@@
@@@@@@@@@..@@...@@@@
@@@@@@@@@@.@.@.@.@.@
@@@@@@@@@..@.@......
@@@@@@@@..@..@.@.@@.
@@@@@@@@@...@.@@.@.@
@@@.......@......@.@
@@@@.@@.@.@.@@.@...@
15
11 10 0
18 15 0
9 2 0
18 14 0
16 16 0
9 15 1
19 16 1
16 3 1
9 13 1
9 18 1
14 14 2
17 2 2
15 5 2
13 18 2
13 17 2

14 15 0
12 9 0
16 19 0
11 1 0
9 18 0
9 16 1
12 1 1
13 18 1
19 8 1
11 7 1
19 6 2
18 6 2
16 17 2
14 8 2
13 17 2
