width 20
height 20
@.......@@@.@@..@@@@
..@.@@@@@@.....@@@@@
.@.@@.@.@.@.@@@@@@@@
.............@.@@@@@
@.@@.@.@@.@@@...@@@@
..@.@.@@...@.@.@@@@@
.@......@.@.....@@@@
@.@.@.@....@.@.@@@@@
@....@@@.@@...@@@@@@
@.@.@..@.@@@@..@@@@@
...@..@.@.....@@@@@.
@.@.@.@...@@.@.@@@@.
........@.@@@@.@.@..
@.@.@.@..@@@......@.
@@...@..@@@..@.@@...
@@@.@.@@.@.@.@@@@@.@
@@.............@@@.@
@@@.@.@.@.@.@.@.@.@.
@@..@@.@@..@........
@@.@......@@@.@.@.@@
15
5 5 0
3 3 0
7 17 0
7 13 0
2 6 0
5 12 1
3 1 1
3 14 1
10 18 1
19 12 1
11 8 2
0 2 2
2 16 2
10 15 2
14 1 2

4 6 0
9 16 0
3 3 0
0 10 0
17 18 0
6 0 1
14 9 1
18 16 1
2 6 1
5 7 1
14 6 2
12 6 2
2 0 2
6 4 2
11 10 2
