width 20
height 20
.@.@.@.@.......@@.@@
........@@@@.@.....@
.@@@@.@...@@@@.@.@..
@....@..@.@@@.@@@..@
@.@@.@@@...@@..@.@..
..@.@.@.@@...@.....@
@..........@...@.@..
..@.@@.@@.@..@.@@..@
@@....@@@..@.@@@..@@
@@@.@..@.@@.....@...
@@@@..@..@@@.@@.@.@@
@@@@.@..@.@.@@@..@@@
@.@.@.@.....@@..@@@@
........@.@...@.@@@@
.@.@.@@@..@.@@....@.
@...@.@.@.@.@@@@@...
@@.@..@.@@.@.@....@.
@....@.........@.@..
.@.@...@.@@@.@..@@@.
...@.@..@....@.@@@..
15
15 13 0
5 6 0
1 1 0
19 17 0
0 14 0
6 13 1
14 0 1
8 6 1
9 0 1
0 19 1
18 2 2
9 14 2
5 2 2
16 1 2
8 4 2

11 14 0
8 9 0
5 2 0
14 6 0
11 19 0
2 15 1
12 6 1
11 13 1
1 12 1
11 5 1
3 5 2
14 17 2
17 14 2
0 5 2
7 19 2
