width 20
height 20
@@@@@@@...@@@@@@@@@@
@@@@@@@.@..@@@@@@@@@
@@@@@@@..@..@@@@@@@@
@@@@@@@@@@.@@@@@@@@@
@.@@@@@@@...@@@@@@@@
..@@@@@@.@.@.@@@@@@@
@..@@@@........@@@@@
@.@.@@.@.@.@.@.@@@@@
.....@.@..@...@.@@@@
@@@.@..@.@@.@@..@@@@
@.....@@@......@@@@@
..@.@..@..@.@@.@@.@@
.@.@.@.@@.@@@.......
@@......@@.@.@.@.@.@
@..@@.@@........@...
@.@@.@.@.@.@.@.@@@.@
...@......@@@@@@@@@@
.@.@.@.@.@.@.@.@.@.@
@.....@@............
@@.@.@@@.@.@@.@.@.@.
15
8 17 0
8 19 0
13 14 0
9 16 0
10 10 0
8 18 1
7 1 1
1 11 1
1 10 1
5 16 1
11 9 2
4 16 2
9 4 2
1 16 2
8 5 2

4 16 0
0 11 0
13 12 0
19 19 0
2 13 0
18 18 1
9 11 1
14 9 1
7 0 1
9 8 1
14 18 2
8 2 2
11 14 2
9 6 2
14 13 2
