width 20
height 20
.@.@.@..@@@@@...@@@@
.......@.@.@.@.@.@@@
.@@@.@.............@
@.@.@.@@.@@@@@.@.@@.
.........@.@.@@@....
.@@.@.@.@@.......@@.
...@.@@@@@.@.@.@..@.
.@...@..@...@...@.@.
@.@@.@.@@@.@.@@.@@@@
@.......@@@...@..@@.
..@@.@@..@.@@.@.@...
.@@.@.@.@.....@..@.@
......@@.@.@@@..@@.@
@.@.@.......@@@.....
...@.@.@.@.@@@@.@.@@
@.@...@@@@..@..@@@@@
...@@....@.@.@..@@@@
@.@.@@.@@......@@@@@
@........@@.@.@@@@@@
@@.@.@.@@@...@@@@@@@
15
12 5 0
8 10 0
3 3 0
1 17 0
15 12 0
7 4 1
19 5 1
12 1 1
3 4 1
6 17 1
12 8 2
13 2 2
17 13 2
19 13 2
12 19 2

0 0 0
18 2 0
16 13 0
0 14 0
16 1 0
0 4 1
14 3 1
9 2 1
7 9 1
17 13 1
4 15 2
1 13 2
1 4 2
14 17 2
10 6 2
