width 20
height 20
....@@@@.@@......@@@
@.@..@@...@.@.@.@@@@
.@..@...@....@.@@@@@
.@@...@@.@.@....@@@@
....@.....@..@@@@@@@
.@.@@.@@.@@@....@@.@
.@@....@@..@.@@.....
.@..@.@...@@@@..@.@.
@.@@.@.@.@.@.@@..@@.
@....@..........@..@
..@@..@.@@.@.@.@.@.@
@..@@@..@.@.@@.@....
@.@....@@...@.@.@@.@
....@.@.@@.@@.......
@.@@..........@@.@.@
.@@.@.@.@.@@@@.@..@@
......@@.@.......@.@
@.@.@.@....@.@.@....
...@.@@@.@..@@@@.@.@
.@...@@@..@..@@@@...
15
15 5 0
0 4 0
13 0 0
3 15 0
1 12 0
5 6 1
8 16 1
14 17 1
2 0 1
3 19 1
8 5 2
15 12 2
18 10 2
19 19 2
12 19 2

15 6 0
14 0 0
10 17 0
15 12 0
18 13 0
16 6 1
17 9 1
6 9 1
3 0 1
17 7 1
1 16 2
3 3 2
11 4 2
7 2 2
18 11 2
