width 20
height 20
..@@.@.@@@@@@@@@@@@@
@.@@.....@@.@@@@@@.@
....@.@@@....@.@.@..
@.@@...@@@.@.....@.@
..@.@.@.@@@..@@.@@..
@........@.@.@..@..@
@@.@@@.@.....@.@..@.
.@@@.@@.@@.@.@@@@...
.........@.@..@@..@.
.@@.@.@.@.@@.@.@.@@.
.@..@@.........@@.@.
@.@..@@.@.@.@.@.@...
....@.@@...@......@@
@.@.@.@@@@..@@.@@...
...@...@...@@@@@.@.@
@@..@.@@@.@@@@......
@..@@.@@..@@@@.@.@.@
..@.@.@..@@@@@..@@@.
@.....@@..@@@@@.....
..@.@@...@@@@@@@.@.@
15
19 10 0
5 9 0
0 7 0
16 15 0
5 16 0
1 16 1
1 3 1
6 3 1
10 14 1
5 2 1
12 10 2
19 8 2
1 13 2
18 3 2
15 17 2

12 3 0
7 7 0
6 1 0
16 18 0
1 11 0
14 13 1
4 1 1
1 8 1
8 18 1
15 18 1
12 9 2
12 7 2
11 10 2
1 3 2
3 19 2
