width 20
height 20
@@@@@@.......@.@@@..
@@@@@.@.@.@@@...@..@
..@......@.@.@.@.@..
@.@.@@.@@..........@
..@..@.@..@@@.@.@@.@
@...@.@.@..@@@..@...
@@@.......@.@@@..@.@
@@.@.@.@@.@..@..@...
@@.@..@@@@.@...@@@.@
@....@@@@...@@.@@@..
.@.@.@@@.@.@.@.@@..@
..@......@...@.@@@..
@.@@.@.@.@.@@.@@@@@.
....@@.@......@.@@@.
@.@..@.@.@.@@...@@@.
...@..@.@..@..@@.@..
@.@@.@....@.@....@.@
@.@.@.@.@...@.@.@@@.
........@@@.@..@.@@.
@@@.@.@....@@@......
15
19 18 0
12 11 0
9 15 0
15 19 0
3 5 0
11 11 1
14 10 1
12 15 1
4 12 1
14 0 1
19 0 2
6 18 2
17 19 2
3 9 2
12 10 2

10 5 0
11 18 0
14 5 0
3 5 0
18 19 0
9 15 1
18 10 1
19 15 1
8 13 1
5 5 1
2 7 2
0 4 2
19 13 2
10 13 2
18 4 2
