width 20
height 20
.@..@...@@...@..@@@.
...@@.@...@@...@@@..
.@...@..@@.@.@@.@.@.
@.@.@.@.............
@.......@.@@.@.@.@@.
..@@.@@.@@@@..@...@.
@.@@@....@@..@.@.@.@
...@@@.@@@@@@......@
@.@@@@@@@@@..@.@.@@@
...@@@..@@@.@..@@@@@
@.@.@@.@.@..@@...@@.
.@@.@......@.@@.@.@.
....@@.@.@..........
.@@....@..@.@.@.@.@.
@@@@@.@@.@...@..@@@@
@@@@@.@@@.@.@.@@..@.
@@@@@@@@@.@.....@.@.
@@@@@@@@@...@.@.....
@@@@@@@@@@.@.@@.@.@.
@@@@@@@@@@@......@@.
15
5 4 0
15 10 0
13 3 0
0 0 0
17 17 0
1 6 1
11 6 1
14 19 1
0 5 1
8 11 1
19 0 2
6 0 2
12 12 2
12 6 2
19 11 2

15 14 0
14 19 0
12 18 0
19 0 0
19 12 0
11 3 1
7 9 1
12 2 1
1 9 1
15 12 1
19 4 2
4 5 2
10 11 2
3 2 2
10 12 2
