width 20
height 20
@@@@@@@@@@@@@@@.@@@@
@@@@@@@@@@@......@@@
@@@@@@@@@@@@.@@.@.@@
@@@@@@@@@@@..@......
@@@@@@@@@@@@@.@.@.@.
@@@@@@@@@@@......@..
@@@@@@@@@@..@.@@@.@.
@@@@@@@@@@@.@.@.....
@@@@@@@@@@.@.@.@.@.@
@@@@@@@@.......@..@@
@@@@@@@@@.@.@@...@.@
@@@@@@@@...@@@.@.@.@
@@@@@@@@@.@.@@@.....
@@@@@@@@@@..@@.@.@.@
@@@@@@@@@@@.......@@
@@@@@@@@@@@@@.@.@@@@
@@@@@@@@@@@....@@@@@
@@@@@@@..@@@@.@@@@@@
@@@@@@@@.@@....@@@@@
@@@@@@@.....@.@@@@@@
15
10 6 0
13 16 0
16 14 0
15 3 0
10 11 0
14 9 1
15 14 1
18 3 1
15 12 1
11 9 1
11 6 2
13 14 2
14 10 2
8 17 2
16 7 2

7 17 0
10 11 0
16 13 0
13 1 0
12 3 0
15 3 1
17 7 1
18 3 1
13 9 1
13 17 1
13 6 2
13 16 2
11 19 2
11 16 2
11 14 2
