width 20
height 20
@@.@.@@@@@@@...@....
......@@@@@@.@...@.@
.@.@@@.@@.@.@.@@..@.
@................@@.
.@@.@.@.@.@@@.@.@...
.....@.@.@@....@@.@.
.@@.@......@.@@@.@..
...@.@@.@@..@@@....@
.@...@..@.@@.@.@.@..
@@.@..@...........@@
@.@..@..@.@@@@@.@@@.
....@@.@.@.@.@.@.@..
@.@.@............@@.
...@@@.@@@.@.@.@....
@.@.@.@.@.@.@@.@.@@.
............@.@...@.
@.@.@.@.@.@....@.@.@
.@...@..@@..@@......
.@@.@@@..@@..@.@.@.@
....@@@.@...@@@@@...
15
3 18 0
0 19 0
4 5 0
8 5 0
11 18 0
2 2 1
0 4 1
14 1 1
13 0 1
1 5 1
17 4 2
1 19 2
14 11 2
4 7 2
13 9 2

11 2 0
2 15 0
3 17 0
14 0 0
16 3 0
10 19 1
0 6 1
9 6 1
10 17 1
19 4 1
7 19 2
17 4 2
8 18 2
0 1 2
11 17 2
