width 20
height 20
@@@@@...@.@..@@....@
@@@@..@...@@....@@.@
@@@..@@.@.@@.@@.@.@.
@@@@@@...@@@.@......
@@@@...@@.@.@@.@@.@.
..@@@@........@...@.
.@.@...@.@@.@@.@.@..
....@@@@@@.....@@.@.
@.@..@.@..@@.@......
...@.....@@.@..@.@@@
@.@@@.@@......@@@@@@
.....@..@.@.@.@@@@@@
@.@@@@@....@.@@@@@@@
......@.@@.@.@@@@@@@
@.@@.@@@.....@@@@@@@
...@@@@.@.@@.@@@@@@@
@.@@.......@...@@@@@
...@.@.@.@@@@.@.@@@@
@.@..@.@@@@@@....@@@
...@.@......@.@@@@@@
15
4 11 0
0 11 0
3 13 0
10 13 0
5 0 0
16 6 1
6 19 1
8 3 1
10 10 1
17 5 1
19 6 2
6 16 2
13 17 2
6 3 2
1 15 2

7 19 0
5 0 0
7 16 0
12 15 0
6 18 0
12 7 1
6 8 1
18 8 1
13 1 1
13 10 1
1 13 2
8 16 2
3 2 2
11 11 2
8 10 2
