width 20
height 20
@..@.@...@@.@.@@@.@.
..@...@@.@..@.......
@..@@......@..@.@.@.
.@....@@@.@@@..@@@..
.@.@.@@@@@@@@@@.@.@.
.@.@@@.@@@@@@@......
.@..@...@..@@.@.@.@.
...@..@@..@......@@@
.@...@.@.@.@@.@.@@@@
@@@@...........@@@@@
.@...@@@.@.@@.@.@..@
...@....@@@@.....@..
@.@@.@.@@@@@@@.@..@.
.@....@@@@@@@.@.@...
...@.@@@@@@@......@@
.@..@@@@@@@..@.@.@@@
..@...@@@@@@..@.@@@@
.@@@.@@@@@@@@...@@@@
.@@@@@@@@@@@..@@@@@@
@@@@@@@@@@@@@..@@@@@
15
13 8 0
14 3 0
18 13 0
2 6 0
19 5 0
17 2 1
15 4 1
16 5 1
12 7 1
4 17 1
7 6 2
15 1 2
14 5 2
13 18 2
19 1 2

8 7 0
13 0 0
17 2 0
17 0 0
15 1 0
17 5 1
8 1 1
6 5 1
1 16 1
14 19 1
12 2 2
5 9 2
4 9 2
11 0 2
19 0 2
