width 20
height 20
@@@@@@.@@.@@.@.@.@.@
@@@@@..............@
..@@..@.@.@@.@@.@.@@
.@@@@..@...@@..@..@@
..@@@.@.@.@..@..@..@
.@..@@@...@@...@@.@.
.@.@...@.@...@......
.....@@...@.@..@.@.@
@@@@.@.@@..@@.@@@...
@@.@....@@..@@.@.@@.
.....@@.@.@......@@@
@.@.@@@@....@@.@..@@
...@@@@@@.@.@@@@@...
@.@@@@@.@..@.@....@@
...@@@....@...@.@...
@.@.@.@.@.@.@@...@.@
........@@..@..@@.@@
.@.@@.@@..@..@.....@
..@@@....@.@.@.@@.@.
.@@@@@@@......@.....
15
11 10 0
0 3 0
13 14 0
5 3 0
12 19 0
12 18 1
11 19 1
0 19 1
10 3 1
7 18 1
16 0 2
9 11 2
9 1 2
16 9 2
10 9 2

4 2 0
0 6 0
11 16 0
1 16 0
14 15 0
17 17 1
14 1 1
10 3 1
4 9 1
16 0 1
6 18 2
17 11 2
5 9 2
7 4 2
0 2 2
