width 20
height 20
@......@.@..@.@.@.@.
..@@.@@...@.........
@.@.@@.@.@..@.@@.@.@
..........@..@..@.@@
.@@@.@.@.@@.@.@...@@
..@...@.......@.@..@
@.@@.@@.@.@.@...@.@.
@@@@..@..@...@.@....
@@.@.@@@@..@.@@@@.@.
.@.@@.@.@@..@.@.@@@.
.........@.@@...@.@.
.@@.@.@.@@@@..@.....
...@...@@@...@..@.@.
@.@.@.@.@.@.@@@@@@..
@@..@........@@@@@@.
@.@.@.@.@.@@@@@@@@@@
.....@..@@@@@@@@@@@@
@.@@.@.@@@@@@@@@@@@@
@@.......@@@@@@@@@@@
@..@.@.@@@@@@@@@@@@@
15
7 11 0
11 14 0
11 5 0
2 10 0
3 15 0
3 18 1
5 0 1
9 15 1
17 5 1
13 9 1
2 14 2
13 4 2
8 18 2
11 13 2
0 10 2

19 11 0
11 14 0
1 12 0
17 6 0
3 3 0
19 10 1
8 3 1
1 19 1
6 19 1
10 14 1
10 7 2
14 7 2
5 5 2
4 7 2
7 9 2
