width 20
height 20
..@@.........@@@@@@@
@....@@@.@.@@@@@@@@@
.@.@@.@.@.@@@@@@@@@@
..........@@@@@@@@@@
.@@@.@@@@..@@@@@@@@@
@.@@@.@.@.@@@@@@@@@@
@.@@......@@@@@@.@@@
..@.@.@@@@.@@@@..@@@
@.....@@@@...@.@..@@
.@.@@@.@@..@@...@...
.........@.@@@@...@@
@@.@@@.@....@@..@@@@
.@@.@@@..@@.@@@....@
.....@@@..@..@@@.@..
.@@.@@@@@@.@......@@
.@@..@@@@..@.@.@.@.@
..@.@@@@.@..@@@.....
.@.@..@....@@@..@.@.
.....@.@.@@.@.@..@..
@.@@............@@.@
15
1 6 0
3 8 0
3 13 0
7 0 0
0 0 0
1 3 1
4 13 1
5 17 1
9 2 1
10 19 1
12 15 2
6 6 2
15 18 2
15 10 2
10 7 2

15 12 0
9 6 0
6 19 0
17 17 0
8 0 0
3 8 1
9 19 1
10 0 1
5 2 1
3 10 1
5 17 2
10 15 2
15 18 2
13 19 2
9 2 2
