width 20
height 20
@@@.@@@.@@@@@@@@..@@
.....@..@.@@@@@.@...
@@.@.@@.....@.....@.
.@@@.@.@.@@@@@@.@@.@
...@.@......@......@
.@.....@@.@.@@@@@@..
@@.@@.@...@...@.@@.@
...@.@@@.@@.@.......
.@....@@@..@@.@.@.@.
@..@.@.@.@.@.@..@@..
@@@..@........@...@.
@@@@.@@.@.@@.@..@@@@
@@@@@@...@@@..@..@@@
@@@@@@@.@@@.@.@.@.@.
@@@@@@@@@@........@.
@@@@@@@@@@@.@.@.@...
@@@@@@@@@@@@...@@@.@
@@@@@@@@@@@@@.@.@.@@
@@@@@@@@@@@@@......@
@@@@@@@@@@@@..@.@.@@
15
15 6 0
14 14 0
12 16 0
7 0 0
5 8 0
18 1 1
2 5 1
17 2 1
3 0 1
18 16 1
17 14 2
10 2 2
15 14 2
0 8 2
19 13 2

2 9 0
4 11 0
4 10 0
5 8 0
15 8 0
15 1 1
11 14 1
7 6 1
6 9 1
10 4 1
19 15 2
11 7 2
3 8 2
0 7 2
18 16 2
