width 20
height 20
.@@@.@.@.@@.@.....@@
..@..........@.@.@@.
.@.@.@.@.@.@.@@.....
......@.@@@..@@@.@@.
.@.@@....@@@..@.@.@.
.@..@.@.@.@.@.@.....
..@@.@@@........@.@.
@@....@.@.@.@.@.@@@@
@@@.@...@..@@@..@..@
@@...@@...@..@.@.@..
@@@@.@.@@@..@.@@...@
@@@@....@@@......@..
@@@..@.@...@.@.@.@.@
@@.@..@..@@...@@@.@.
@@...@.@.@.@@.......
@@.@@.........@.@.@.
....@.@.@.@@.@...@..
.@.@...@.@@.@.@@@.@.
.@@.@@...@@.@..@....
.......@......@..@.@
15
3 14 0
18 9 0
4 10 0
11 9 0
5 11 0
5 8 1
7 15 1
16 5 1
4 14 1
14 14 1
0 4 2
18 14 2
1 6 2
16 9 2
10 2 2

16 2 0
8 18 0
2 9 0
19 14 0
8 19 0
11 7 1
4 9 1
0 18 1
3 1 1
10 15 1
14 18 2
2 16 2
17 14 2
9 1 2
12 13 2
