width 20
height 20
.@..@.@..@@@@.@@@@@@
..@....@..@....@@@@@
@...@@@..@.@@.@.@@@@
@.@@@@.@.@......@@@@
...........@.@@.@@@@
.@@@.@@.@@..@...@.@@
...@.@.@.@.@@.@...@.
.@@.@@...@@@@.@@@.@.
@.@....@.@.@.@....@.
@...@.@@......@@.@..
..@@.@.@.@.@@.....@.
@.@..@..@.@.@.@.@...
....@@@.......@.@.@@
@@@..@..@.@@.@.@.@@.
@@@.@.@@..@@@@......
@@....@..@.@.@.@.@.@
@.@.@.@@......@@@..@
...@...@.@.@@@@@.@..
@.@.@.@.@.@@.@@....@
................@.@@
15
3 1 0
12 16 0
5 0 0
0 19 0
4 11 0
7 11 1
8 4 1
4 1 1
4 5 1
19 10 1
2 17 2
12 15 2
19 6 2
1 10 2
16 15 2

2 19 0
12 16 0
2 2 0
1 1 0
7 4 0
1 19 1
8 3 1
0 12 1
16 9 1
15 10 1
5 1 2
6 10 2
3 14 2
5 19 2
15 19 2
