width 20
height 20
@@.@........@@@@.@@@
@..@@.@.@.@...@...@@
.@.@@@@..@@.@@.@.@@@
........@@........@.
.@@.@.@...@.@@@.@@..
..@..@@.@..@....@..@
.@..@@@.@.@@@.@..@.@
..@@.@.@.@.@.@.@....
.@@@.............@.@
..@..@.@.@.@.@.@.@..
.@@@.@@.@@@@@@@@@..@
@.....@.@@.@.@.@.@..
@@.@.@.............@
@@@.@.@.@.@.@@.@.@.@
@@@.....@@.@@.@@@.@@
@@.@@.@.............
.......@.@.@.@.@.@.@
.@@.@.@@..@@@@..@@.@
@....@.@@@.@...@....
@.@.@........@..@.@@
15
8 9 0
10 15 0
2 2 0
16 2 0
0 5 0
7 5 1
16 7 1
17 19 1
0 6 1
16 18 1
12 16 2
7 14 2
12 1 2
0 10 2
3 9 2

10 11 0
14 7 0
12 15 0
17 14 0
17 19 0
8 0 1
16 7 1
12 1 1
15 6 1
15 1 1
7 19 2
6 3 2
9 1 2
8 15 2
15 5 2
