width 20
height 20
@@.......@.@@@@@@...
@@@.@.@.@@..@.@@.@.@
@@@.@..@.@.@........
.@..@@.....@@@.@.@.@
...@@..@.@..@.@...@@
.@...@..@..@@..@.@.@
..@.@@.@.@.@@@......
.@....@@....@..@.@@.
@.@.@@...@.@.@.@@...
@.@..@@@..@.....@.@.
...@@.@@.@.@.@.@@@..
@.@.@.........@@@@@.
......@.@.@.@..@@@@@
@.@.@@@@..@@..@.@@@@
@..@.....@.@@.....@@
@@@..@.@.....@.@@@.@
@@@@..@..@.@@.......
@@.@.@..@....@@.@.@.
@....@@@@@@.@@@@@..@
@@.@..@@@...@@@@@@@@
15
18 10 0
14 9 0
9 17 0
3 1 0
15 6 0
13 2 1
10 0 1
6 8 1
14 6 1
17 4 1
18 8 2
18 6 2
4 12 2
6 3 2
0 4 2

19 9 0
16 4 0
2 5 0
19 2 0
4 0 0
6 3 1
10 2 1
11 7 1
4 9 1
18 6 1
12 8 2
18 3 2
3 5 2
5 11 2
6 5 2
