width 20
height 20
@..@......@.@@..@@@.
.@..@@@@.@@.@@.@@.@.
...@................
.@..@.@@@.@.@.@.@@@.
..@@.....@.@.@.@....
.@.@@@@@........@@.@
.@.......@.@.@.@.@@.
...@.@.@.@@...@@....
.@.@@.@@@.@@.@...@@@
..@.@.@@@..@@..@....
.@.....@.@.@@@@.@.@@
...@.@........@....@
@@@.@@.@.@.@.@@.@.@@
@@..@@@@@@@@....@@@@
@@.@@..@@@.@.@.@.@@@
......@.@..@@@....@@
@@@@@....@...@.@.@.@
@@@@@.@.@.@.@.@@....
@@@@@@...........@@@
@@@@@..@@.@.@.@@....
15
3 15 0
4 15 0
13 3 0
13 7 0
2 14 0
19 0 1
0 6 1
12 18 1
8 11 1
13 11 1
15 5 2
13 19 2
17 4 2
3 10 2
17 19 2

14 2 0
3 15 0
12 2 0
10 5 0
4 0 0
2 7 1
10 14 1
17 11 1
12 5 1
9 0 1
6 18 2
9 8 2
7 6 2
0 10 2
19 17 2
