width 20
height 20
@@@@@@@@@@@.....@..@
@@@.@@@@.@..@.@@..@.
.@.......@@.@@@@@...
..@@@@.@....@..@.@@.
.@.....@@.@..@...@..
...@.@...@@@.@.@..@.
.@.@..@.@@@.....@...
..@..@@..@.@@.@@@.@@
@.@@.@.@@......@@@.@
.@@@@.....@@.@.@@..@
..@.@.@.@..@@..@.@..
@......@@@.@@@.....@
..@@.@@.@.@@.@.@@@..
@.@.@.@......@.@.@.@
........@@.@..@.....
@.@.@.@.@.@.@.@@.@.@
@@@@@@@@@....@@@@...
@@@@@.@.@.@@@.@@.@.@
@@.................@
@@@.@.@.@.@@.@.@.@..
15
6 8 0
12 16 0
17 0 0
18 13 0
2 11 0
4 18 1
12 19 1
7 5 1
11 18 1
12 13 1
16 18 2
10 1 2
18 12 2
15 4 2
13 14 2

5 11 0
13 15 0
5 13 0
12 14 0
18 19 0
14 19 1
18 13 1
14 18 1
9 19 1
7 12 1
18 17 2
11 1 2
15 0 2
0 4 2
19 14 2
