width 20
height 20
@..@..@.@.@@@..@@@@@
@.@.@.@....@.@.@@@@@
........@.@.....@@@@
@.@.@.@.@...@.@@@@@@
@@@..@@.@.@.@@..@@@@
.@.@@@@@.@@.@.@..@@.
....@@@.......@.@@..
@.@@.@.@.@@.@.....@.
...@.......@@.@@.@..
.@...@.@.@..@@.....@
..@@..@@.@.@..@@@.@@
.@.@@@.@@@...@.@.@.@
.....@.@@@.@.@.....@
.@.@....@@@....@.@..
@@@@@.@@.@@@.@..@@@.
@@.....@..@...@.@@.@
@.@.@@@@.@.@.@.@....
....@............@.@
@.@..@.@.@@@@.@.@...
@@..@...@@@@@@...@.@
15
15 12 0
2 13 0
2 15 0
16 19 0
14 9 0
8 10 1
5 1 1
9 3 1
4 0 1
12 13 1
5 8 2
0 17 2
9 8 2
8 8 2
6 11 2

19 14 0
2 0 0
4 15 0
16 17 0
12 11 0
13 6 1
5 1 1
9 4 1
1 16 1
0 13 1
10 10 2
7 1 2
5 8 2
3 17 2
11 4 2
