width 20
height 20
@@@@@@@@@@@@@@@@.@.@
@@@@@@@@@@@@@@@.....
@@@@@@@@@@@@@@@@@.@@
@@@@@@@@@@@@@@@...@.
@@@@@@@@@@@@@@@.@.@.
@@@@@@@@@@@.@@...@..
@@@@@@@@@@....@@.@@.
@@@@@@@.@.@.@.@.....
@@@@@.......@@@@.@.@
@.....@.@.@@..@@@...
..@.@..@@.@.@.@@.@.@
@..@@.@@.........@.@
..@..@@.@@@@.@.@.@..
.@.@..........@@...@
@@.@@.@.@@.@.@..@.@@
......@@.@@....@.@.@
.@.@@......@.@......
..@@@@.@@.@@@..@.@.@
.@@@@....@....@.@...
.@@@..@.@..@@....@@@
15
16 6 0
11 18 0
5 8 0
6 18 0
5 10 0
13 15 1
16 7 1
12 9 1
2 14 1
16 15 1
1 11 2
9 8 2
4 13 2
15 14 2
6 17 2

0 13 0
4 12 0
19 12 0
5 15 0
13 15 0
13 17 1
7 13 1
9 9 1
18 0 1
15 16 1
9 10 2
9 8 2
18 10 2
0 18 2
8 16 2
