width 20
height 20
@@@@@@@@..@.@@.@..@.
@@@@.@@@.@...@..@...
@@@...@...@.@.@...@.
@@@@.@.@@.@...@.@@.@
@@@.........@.......
@@..@.@.@.@.@.@.@.@.
@@@.@..@.@@.@.@@...@
@@...@.@.@.@..@@@.@.
@@@.@.@@.....@@@....
@@@.....@@.@.@.@@.@.
@@@@@.@..@..@@..@.@.
@@@@...@@.@@@..@.@.@
@@@..@@....@.@......
@@..@@@.@@@....@.@.@
@@@..@...@@@.@@@@..@
@@@.@@.@.@@..@.@.@.@
@@....@....@.@......
@@@.@@@.@@....@@.@.@
.........@.@.@@@@...
.@@.@.@.@@..@@@@@@.@
15
11 1 0
19 7 0
18 19 0
6 15 0
14 0 0
9 0 1
12 12 1
18 17 1
4 2 1
3 2 1
8 12 2
7 19 2
16 4 2
8 10 2
7 2 2

6 18 0
18 11 0
11 1 0
9 16 0
14 12 0
3 15 1
0 18 1
4 4 1
11 4 1
18 15 1
8 4 2
8 7 2
7 16 2
2 18 2
14 1 2
