width 20
height 20
@@@@@@@@.@@@@@@@@@@@
@@@@@@@@..@@@@@@.@@@
@@@@@@@..@@@@@@...@@
@@@@.@@.@.@.@@..@..@
@@@............@.@@.
@@@@.@.@.@@.@@......
@@@@..@@@@@..@@@@@@@
@@@.@..@@@.@@.@.@.@.
@@....@.@...........
@@@.@@...@.@.@@.@.@.
@@.....@@@..@.@.@@..
@.@.@@@.@.@.@..@.@.@
..@.@.......@.@.....
@.....@@.@.@....@.@.
@.@.@...@@@@@.@@.@..
@@...@.@.@.@@.@..@@.
@.@.@.@.....@@..@.@@
.......@.@.@..@.@.@@
@.@.@@.@.@@.@......@
@..@..........@.@.@@
15
7 2 0
13 18 0
5 17 0
4 15 0
11 19 0
6 14 1
4 6 1
1 19 1
16 1 1
3 4 1
8 0 2
7 14 2
17 5 2
9 11 2
3 13 2

11 18 0
8 5 0
17 13 0
10 8 0
8 19 0
14 13 1
19 4 1
15 17 1
10 9 1
6 10 1
19 8 2
6 5 2
8 17 2
5 7 2
13 11 2
