width 20
height 20
@........@@@@..@.@..
..@.@@.@@.@@@@.@.@.@
@.@@..@.@.@@.......@
@.@.@......@.@.@.@..
......@.@.@@..@@..@.
.@.@.@.@@..@.@@@.@.@
..@@@@....@.@.@.....
@.@@.@@.@......@@.@.
......@@@@.@@.@@@@..
.@.@.@@.@@@..@@@.@@.
@@@......@.@..@@.@..
@@@@@.@.@@...@....@.
@@@..@...@.@@.@.@...
@@@.@.@.@......@@@@.
@@@......@@@.@..@@..
@@.@.@.@@.@@@.@.@.@.
@@...@@.@...........
@@@.@.@.@.@.@.@.@.@.
@@@........@@@...@..
@@@@.@.@.@@@@@@.@@@.
15
11 11 0
7 14 0
8 0 0
18 1 0
1 0 0
19 15 1
15 6 1
0 1 1
5 17 1
17 17 1
1 7 2
3 10 2
10 18 2
5 3 2
19 10 2

5 2 0
4 18 0
4 14 0
3 13 0
10 12 0
9 7 1
4 9 1
10 11 1
8 10 1
11 13 1
6 19 2
6 14 2
4 7 2
19 4 2
4 10 2
