width 20
height 20
@@@....@@@@@@@..@@@@
@@.@.@@...@@@@.@.@@@
......@.@@...@...@@@
@.@.@@.....@..@@..@.
...@...@.@..@@...@..
@.@..@@.@.@.@@@@.@@.
..@.@.......@@...@..
@..@..@.@.@.@.@.@.@.
@.@..@@..@@@........
...@.@@.@.@..@.@@.@@
.@@.@.@.@...@.@..@.@
..........@.....@...
@.@@@.@.@..@.@@...@.
..@.@..@..@.@..@@@..
@...@.@@.@@.@.@@.@@.
@.@..@...@..........
@@..@@@.@.@.@.@.@.@.
@@@@....@....@...@..
@@@@@.@.@.@@.@@.@.@.
@@@@@..@...@..@....@
15
2 7 0
19 12 0
19 5 0
3 0 0
5 2 0
14 17 1
10 15 1
2 2 1
3 3 1
5 12 1
16 15 2
4 8 2
3 14 2
5 0 2
11 5 2

13 7 0
1 2 0
9 10 0
3 10 0
15 11 0
11 2 1
2 4 1
14 15 1
17 19 1
11 9 1
3 13 2
15 16 2
19 16 2
4 4 2
15 0 2
