width 20
height 20
.....@.@@@@@@@@@@@..
.@.@....@@@@@@@@@..@
..@..@.@.@@@@@@...@.
@.@.@....@@@@@@.@.@.
...@@@@.@@@@@..@....
@.@.@@.@@@@@@@.@@.@@
.......@@@@@@@.@....
@@@.@.@@@@@@@....@.@
..@..@@@@@@@..@@.@@@
@..@.@@@.@..@@.@..@@
..@...@...@......@.@
@.@.@@.@.@..@.@.@..@
...........@.@.@@@..
.@@@.@@.@@......@..@
@@@@@@@@..@.@@.@@@.@
@@@@@@@@@.....@.@...
@@@@@@@@@.@.@....@.@
@@@@@@@....@..@.@..@
@@@@@@@@@.@.@@....@@
@@@@@@@@@...@@@.@.@@
15
0 10 0
7 1 0
1 2 0
9 12 0
9 16 0
10 15 1
0 13 1
3 2 1
7 17 1
10 12 1
3 5 2
1 6 2
12 17 2
15 17 2
11 11 2

16 2 0
17 11 0
4 12 0
4 1 0
15 15 0
0 0 1
1 6 1
4 8 1
17 13 1
2 6 1
17 4 2
3 6 2
15 16 2
8 3 2
4 0 2
