width 20
height 20
.@.@.@@..@.@..@@.@..
........@....@....@.
@@@@@.@..@.@@.@.@...
@.@..@..@......@..@.
....@.@.@@.@@@.@.@@@
@.@.......@.@.......
@.@.@.@@.@...@.@.@.@
...@@@..@..@.@@.@@.@
@.@.@.@...@.@.@.@@..
........@..........@
@.@.@.@@@@.@.@.@.@.@
...@..@.@@@.@@@@@@@.
@.@@@....@@.@@......
@@@@@@@.@.@.@.@.@.@.
@@@@@@.........@...@
@@@@@.@.@.@.@.@..@..
@@@@...@.@...@@.@.@.
@.@.@.@....@.@.@@...
........@.@.....@.@.
@@.@.@.@...@.@@....@
15
11 5 0
6 19 0
16 3 0
1 17 0
3 5 0
5 9 1
5 11 1
4 3 1
8 12 1
1 9 1
17 14 2
10 19 2
8 6 2
19 5 2
17 18 2

11 5 0
0 0 0
16 3 0
8 2 0
7 17 0
16 19 1
14 10 1
0 1 1
7 14 1
15 9 1
0 4 2
2 11 2
13 0 2
11 14 2
17 1 2
