width 20
height 20
@@@@@@@...@@@@..@.@@
@@@@@@@@.@.@@.@....@
@@@@@@@.........@@@@
@@@@@@@@.@.@@.@@..@@
@@@@@@.@@@.@..@@.@@.
@@@@@...@@..@.......
@@@@..@....@@.@@@.@.
@@@@@..@.@@@...@@@..
@@@@@.@.@@..@@@@@@@.
@@@@..@.@..@@@@@@@@@
@@@.@.@..@.@@@@@@@@@
@@.....@....@@@@@@@@
@..@.@...@.@@@@@@@@@
@@..@@.@@.@.@@@@@@@@
..@.@.....@...@@@@@@
.@.@.@@.@...@..@@@.@
......@.@@@.@.@@@...
.@.@.@.@..@.@@@@.@.@
@@@.....@...........
@@@.@.@...@.@.@.@.@.
15
8 11 0
7 2 0
10 15 0
18 15 0
6 18 0
6 13 1
0 15 1
16 18 1
11 13 1
13 6 1
11 5 2
14 5 2
5 7 2
14 7 2
12 4 2

19 7 0
11 16 0
8 6 0
15 1 0
7 8 0
8 19 1
13 15 1
10 3 1
11 13 1
16 18 1
16 17 2
11 19 2
13 7 2
11 14 2
7 5 2
