width 20
height 20
@@.....@@@......@@@@
@..@@.@.@.@.@@.@@@@@
..@...........@@@@@@
@.@.@.@@.@@@.@@@@@@@
..@@@@..@@@..@@@@@@@
@..@@@@.@@.@.....@@@
..@@@@.....@.@.@.@@@
.@@@@..@.@.@@.@...@@
..@@.@@@@......@.@.@
.@@@..@.@@.@.@@.....
..@@@.....@...@.@@@.
.@.@.@.@.@.@.@.@....
.......@@.......@@.@
@@.@.@@...@@@.@.....
@@@...@@@.@@...@.@.@
@@@@@..@.@@@@.@.@@@@
@@@@@@....@@@...@@.@
@@@@@@.@@@.@..@.....
@@@@@......@.@..@@.@
@@@@@@@@.@.@.@.@@@@@
15
8 7 0
7 5 0
2 13 0
12 3 0
18 12 0
18 18 1
12 14 1
15 5 1
7 6 1
13 5 1
11 0 2
13 12 2
6 16 2
6 0 2
4 8 2

1 5 0
3 0 0
9 14 0
7 2 0
2 11 0
18 16 1
7 6 1
10 0 1
8 19 1
9 12 1
4 12 2
19 9 2
14 12 2
5 2 2
5 0 2
