width 20
height 20
@@@@@@@@@.@@.@@@@@@@
@@@@@@@@......@@@@@@
@@@@@@@.@.@@.@@@@@@@
@@@@@.....@....@@@@@
@@@@@@@.@.@.@.@.@@@@
@@@@@@...@.@....@@@@
@@@@@.@.@@..@.@..@@.
..@@....@..@.@..@@..
@...@.@..@....@.@.@.
.@.@...@@.@@.@@.....
.....@........@.@.@.
.@.@.@.@.@.@.@@..@..
..@@@.@@@.@..@..@@@.
.@.@........@..@@@@@
....@.@.@.@.@.@@@@@@
.@.@@..@.@.@@@@@@@@@
@@@@@.@@...@@@@@@@@@
@@@@..@@.@@@@@@@@@@@
@@@.@....@@@@@@@@@@@
@@@...@.@@@@@@@@@@@@
15
6 11 0
3 8 0
5 14 0
10 13 0
9 1 0
12 5 1
5 8 1
11 4 1
6 5 1
11 3 1
6 3 2
9 7 2
15 5 2
9 9 2
12 9 2

12 10 0
13 6 0
6 10 0
14 3 0
8 8 0
14 12 1
11 4 1
10 16 1
2 8 1
4 10 1
5 17 2
2 10 2
9 3 2
7 10 2
5 12 2
