width 20
height 20
@@@@@@@@.@@@@...@@..
@@@@@@@@.@@@..@.@.@.
@@@@@@@..@@.@..@..@.
@@@@@@.@..@...@@@...
@@@@@....@@.@@.@.@.@
@@@@@.@@@@..........
@@@@..@.@.@.@.@.@.@@
@@@.@.@......@@..@.@
@@@.....@.@.@.@@@...
@@@@.@@..@.@..@.@.@@
@@@@@@@@....@.@...@.
@@@@@@@@@.@@....@...
@@@@@@@@@..@.@.@..@@
@@@@@@@@..@...@.@...
@@@@@@@@@.@.@@....@.
@@@@@@@@....@@@.@.@@
@@@@@@@@@.@@@@.@....
@@@@@@@@@@@.....@@.@
@@@@@@@.....@.@....@
@@@@@@@@@.@..@@@.@..
15
7 8 0
9 11 0
10 15 0
16 16 0
13 9 0
11 4 1
8 1 1
10 18 1
11 19 1
10 10 1
14 0 2
10 5 2
4 8 2
15 0 2
8 7 2

7 2 0
15 17 0
13 3 0
6 8 0
9 18 0
9 19 1
17 18 1
9 10 1
15 13 1
6 4 1
12 1 2
17 14 2
16 16 2
9 8 2
15 18 2
