width 20
height 20
@@@@@@@@@@@@@@@@@@@@
@@@@@@@@@@@@@@@@@@@@
@@@@@@@@@@@@@@@@@@@@
@@@@@@@@@@@@@@@@@@@@
@@@@@@@@@@@@@@@@@@@@
@@@@@@@@@@@@@@@@@@@@
@@@@@@@@@@@@@@@@@@@@
@@@@@@@@@@@@@@@@@@@@
@@@@@@@@@@@@@@@@@@@@
@@@@@@@@@@@@@@.@@@@@
@@@@@@@@@@@@@...@@@@
@@@@@.@@.@@@.@.@@@.@
...@.....@@..@..@...
.@@.@.@@..@@...@.@.@
..@.....@.@@.@.....@
.@..@.@.@...@..@.@.@
.@.@.@.@.@.@.@..@..@
.@........@....@.@..
...@.@.@.@.@@@.@.@.@
@@..@@@..........@..
15
3 13 0
3 14 0
16 14 0
12 12 0
8 13 0
16 19 1
11 17 1
14 9 1
5 11 1
0 17 1
14 16 2
15 16 2
2 17 2
1 18 2
4 17 2

14 19 0
17 12 0
0 14 0
1 12 0
13 19 0
11 19 1
14 16 1
2 18 1
4 16 1
8 12 1
10 18 2
0 15 2
16 14 2
9 13 2
15 16 2
