width 20
height 20
@..@.@.@@@@@@....@@.
.@.......@.@.@.@@.@.
...@.@.@............
.@@...@@@.@.@.@.@@.@
...@.@.@.@.@.@..@@@@
@.@@.......@.@.@@@@@
@@@..@.@.@...@.@@@@@
@@@@..@..@.@..@@@@@@
@@..@.@.@@@..@@@@@@@
...@.@.@.@.@..@@@@@@
.@...........@@@@@@@
@.@@.@@.@@.@.@@@@@@@
.......@.@@..@@@@@@@
@@@@.@.@..@@..@.@@@@
.@....@..@.@@...@@@@
..@.@.@@.....@.@.@@@
.@.@@@..@.@@......@@
.......@.@.@.@.@.@@@
@.@.@.@......@@...@@
...@@...@.@@.@@@.@@@
15
1 11 0
6 16 0
13 13 0
8 1 0
12 18 0
6 17 1
14 0 1
1 5 1
12 8 1
0 2 1
10 5 2
3 18 2
5 17 2
11 8 2
14 17 2

3 3 0
14 5 0
10 18 0
4 1 0
1 4 0
2 1 1
6 19 1
8 10 1
4 2 1
12 16 1
14 1 2
1 9 2
3 10 2
14 16 2
9 19 2
