width 20
height 20
@.@@@.@.@....@@@@@@@
@.@@@.@.@@.@@@@@@@@@
@..@.....@..@@@@@.@@
..@.@.@.@..@@.@@...@
@......@@@....@.@.@.
..@.@.@@@..@@.......
@.@@..@.@.@.@.@.@.@.
...@@@...@@..@...@@.
@.@.@.@.@.@.@.@.@..@
............@...@@..
.@.@.@@.@.@...@..@.@
@...@@@@.@@@@..@@@..
@@.@.@...@.@.@@.@.@.
@@.....@............
@@.@.@@@@.@.@@.@@@@.
@@@.@@@@@@@@@@.@..@@
@.@.@..@@.@.@..@.@..
@.@.@.@......@.....@
..@.....@.@.@..@.@@@
@...@.@@@@@...@.....
15
12 13 0
14 17 0
3 5 0
2 9 0
8 7 0
9 8 1
4 10 1
9 14 1
17 3 1
8 13 1
14 15 2
3 17 2
10 0 2
13 19 2
11 13 2

17 3 0
1 4 0
8 7 0
7 7 0
17 8 0
3 18 1
2 19 1
17 4 1
5 5 1
11 17 1
14 13 2
6 16 2
13 5 2
19 11 2
10 5 2
