width 20
height 20
@@@@@.@@@@.....@@@@@
@@@@@..@@..@.@.@@@@@
@@@@@.@.@.@.@.@.@@@@
@@@@.............@@@
@@@@@.@.@.@.@@@.@@@@
@@@@@.@@@@..@@@.@@@@
@@@@@.....@.@@..@@@@
@@@@@@.@@.@@@@@.@@@@
@@@.@@@...@@@@..@@..
@@...@@.@..@@.@....@
@.@.@....@@.@..@.@..
@...@.@.@@@..@..@@.@
..@@.@@@.@@.@.@..@..
@..@...........@.@.@
.@.@.@.@@@.@@@......
......@.@.@@.@.@.@.@
@.@@.@........@...@@
....@.@.@.@.@..@.@.@
@.@....@@..@.@.....@
..@.@.@@@@@@...@.@.@
15
7 11 0
15 6 0
9 17 0
0 17 0
5 11 0
7 13 1
17 16 1
7 6 1
2 14 1
2 11 1
11 6 2
7 8 2
6 16 2
7 3 2
16 15 2

5 10 0
4 18 0
6 13 0
15 7 0
12 18 0
7 9 1
7 6 1
19 8 1
10 18 1
6 16 1
12 0 2
11 13 2
18 10 2
3 15 2
18 11 2
