width 20
height 20
..@@@@@@@@@@.@@@@@@@
.@.@@@@@@@.@..@@@@@@
....@@@@@@...@@@@@@@
@@.@@@@@@.@.@@@@@@@@
@..@.@@@@...@@@@@@@@
@@....@@@.@@@@@@@.@@
@..@@..@...@@@..@..@
.@...@..@.@.@..@..@.
...@..@@.....@.@@...
@@.@@.@@.@.@....@.@.
@...@@....@@.@.@@..@
@@.@.@.@@@@.@..@.@..
@.......@....@.....@
..@.@.@@..@@.@.@.@..
@.@.@@@@@.@..@@@@@.@
@@.....@@@@@.@.....@
@@@.@.@@@@@....@.@.@
@@@@@@@@@@@@@@.@..@@
@@@@@@@@@@.....@.@.@
@@@@@@@@@@@.@.@.....
15
4 11 0
14 15 0
16 7 0
17 17 0
9 7 0
17 8 1
3 5 1
10 2 1
19 8 1
14 17 1
10 4 2
14 12 2
7 12 2
0 13 2
9 5 2

9 14 0
17 9 0
2 9 0
16 18 0
6 12 0
2 10 1
3 15 1
9 13 1
2 2 1
4 8 1
0 8 2
8 10 2
11 3 2
7 10 2
10 2 2
