width 20
height 20
@@@...@...@.@.@@.@..
@@..@@.@.@.........@
@@@..@.....@.@.@.@..
@@@@...@.@..@...@..@
@@@@.@..@@@@@@.@.@.@
@@@@@..@.@.@@@@.....
@@@@.@......@@@@.@.@
@@@....@.@.@@@@.@@..
@@.@.@@...@@@@@....@
@......@.@@@@@@@.@.@
.@.@.@..@@@@@@@...@@
....@..@@@@@@@@@.@@@
.@.@@.@.@@@@@@@@@@@@
..@@.....@@@@@@@@@@@
@@.@@@.@@@@@@@@@@@@@
@.......@@@@@@@@@@@@
@@@.@@.@@@@@@@@@@@@@
@...@..@@@@@@@@@@@@@
@@.@@@@@@@@@@@@@@@@@
@@@@@@@@@@@@@@@@@@@@
15
8 9 0
6 10 0
9 0 0
7 6 0
0 11 0
7 2 1
7 4 1
10 7 1
6 17 1
10 2 1
9 2 2
2 9 2
2 17 2
18 1 2
4 15 2

17 1 0
19 5 0
16 11 0
5 5 0
19 2 0
1 13 1
18 2 1
4 3 1
4 7 1
18 1 1
15 5 2
4 0 2
18 5 2
3 2 2
9 8 2
