width 20
height 20
@.@@@@@........@@@..
...@.@.@.@@@.@..@.@.
@@.......@....@@....
@@@.@@.@@@@.@@...@.@
.@....@@@@@.@.@.@.@.
.@@.@.@@@@....@.....
.@@@..@@@.@.@...@.@.
.....@.@@...@@@..@@.
.@.@.@....@.@..@.@@.
..@@@@@.@..@.@.@.@..
.@@@@@..@@......@..@
@@@@@@@..@.@@.@@@@..
@@@@@@..@..@.@..@..@
@@@@@..@@.@....@.@.@
.@.@.@..@@.@.@......
.......@@..@..@.@.@.
@.@@.@.@.@..@@@@@@..
..@..@.....@.......@
@.@.@.@.@@@@@.@.@.@@
@@@....@@@@@...@..@@
15
16 13 0
7 10 0
18 2 0
0 17 0
1 9 0
7 18 1
8 11 1
13 13 1
16 5 1
6 19 1
0 14 2
6 14 2
18 13 2
2 14 2
17 6 2

16 13 0
18 17 0
9 0 0
6 10 0
3 4 0
15 5 1
4 4 1
12 0 1
5 19 1
2 14 1
18 11 2
12 9 2
16 2 2
3 17 2
6 16 2
