width 20
height 20
.@@@.@@@@..@@.@..@@@
..@.......@.@.@.@@@@
.@@@.@.@.@.......@@@
.....@@...@@.@.@.@@@
.@.@..@.@.@@@.@@...@
@@@@.@.@.@.@.....@@@
@.@@.@.....@@.@.@@.@
.......@.@..@.@@....
@.@.@.@@@..@.....@.@
@@@@@..@.@.@@@@.@...
@@@@.@@......@@@.@@.
@@@.....@@@.@@@.....
@@..@.@..@...@.@.@@.
..@..@@.@.@.@@.....@
.@..@@@.@..@@@.@.@..
...@.@.@@@......@..@
@@.........@.@.@@.@@
@@@.@@@.@@..@.@.....
@@@@......@...@.@.@@
@@@@@.@.@.@@@@@@@@@@
15
19 7 0
8 1 0
2 7 0
2 4 0
6 11 0
15 17 1
8 10 1
7 16 1
6 16 1
5 4 1
5 11 2
15 5 2
6 2 2
14 2 2
4 0 2

7 10 0
11 11 0
5 11 0
19 17 0
9 6 0
8 3 1
14 2 1
13 0 1
5 12 1
18 6 1
4 13 2
10 5 2
18 17 2
14 5 2
8 1 2
