width 20
height 20
..@...@@@@@@@@@@@.@@
@..@.@.@.@@@@@@...@@
..@......@@@@.@@.@.@
@...@@.@..@.........
@@.@@@@..@@@.@.@.@.@
@@@.@@.@.@@.@.@.@...
@@@...............@.
@.@.@.@.@.@@.@.@.@.@
.....@.@.@.@.@@..@..
@.@.@.........@.@.@.
@@.@@.@@.@.@.@@.@...
@@.@....@.@@@@....@.
@@..@.@......@@.@@..
@@.@@@..@.@.@..@@.@.
@@..@.@..@@@@.@@...@
@@.@....@@.@...@.@..
@....@@@@..@@.@.@.@.
@@.@......@.........
@.@@.@.@.@.@@.@.@.@.
......@........@@@..
15
18 12 0
12 3 0
3 7 0
14 19 0
19 5 0
2 19 1
0 8 1
3 16 1
9 16 1
2 15 1
3 8 2
6 13 2
5 14 2
16 7 2
10 10 2

13 19 0
4 16 0
7 14 0
0 0 0
3 7 0
1 7 1
19 19 1
16 8 1
2 15 1
4 15 1
8 6 2
18 17 2
2 16 2
19 17 2
14 15 2
