width 20
height 20
..@@@@@@@@@@@@@..@@.
.@.@@@@@@@@@@@@@.@..
...@@@@@@@@@@@@....@
@@..@@@@@@@@@@.@.@..
.@@..@@@@@@@@.....@.
....@@.@@@@@@.@@.@..
.@@......@@....@@..@
@...@.@.@@@.@@.@@@@.
@@.@.@..@....@..@...
......@.@.@.@@.@.@@.
@@.@.@.@.@@@........
...@.........@.@.@.@
.@.@.@.@@@.@..@@..@.
..@.@@@@.@@.@.@..@..
.@@.@@.......@@@...@
....@@.@.@@.@@.@.@..
.@.@.@..@...@..@@..@
@@.....@.@.@.@.@.@..
.@.@.@...@@........@
....@..@.@@@.@@.@@..
4
15 19 0
4 9 0
1 9 1
19 17 1

19 4 1
8 18 1
7 14 0
16 1 0
