width 20
height 20
....................
..........@.........
..@@................
..@..........@......
............@.......
..........@....@....
...@....@...........
.............@@.....
....@.....@.........
....................
....................
.........@.@......@.
......@.........@...
....................
...@..............@.
................@...
@@@@......@.@.@.....
@@@..@...@..........
@@@....@............
@@@.................
18
15 0 0
8 16 0
13 12 0
14 13 0
10 6 0
16 8 0
11 8 1
4 5 1
1 2 1
12 12 1
13 5 1
8 14 1
19 2 2
2 11 2
9 1 2
0 14 2
19 17 2
10 17 2

17 18 0
10 18 0
2 14 0
17 2 0
11 17 0
12 9 0
0 2 1
7 19 1
1 3 1
9 2 1
0 14 1
8 10 1
1 15 2
0 15 2
17 17 2
15 1 2
19 6 2
12 5 2
