width 20
height 20
..........@......@..
....@...............
...........@........
.........@@...@.....
.....@.@.@@.........
@........@......@...
..@.................
......@.......@.....
....@...............
......@.............
....................
..@...........@...@@
.......@...........@
..........@.@......@
.......@.@.@.......@
....@...............
....@...............
...@@....@..........
..@@@......@........
.@@@@............@@@
18
14 8 0
12 1 0
14 4 0
9 15 0
10 17 0
2 15 0
0 12 1
1 4 1
17 6 1
12 11 1
6 16 1
1 13 1
4 9 2
14 0 2
17 13 2
11 13 2
13 3 2
18 15 2

12 3 0
12 12 0
1 5 0
1 0 0
2 1 0
16 3 0
0 12 1
5 10 1
18 6 1
1 17 1
10 11 1
2 3 1
17 15 2
17 1 2
16 13 2
3 14 2
5 18 2
1 4 2
