width 20
height 20
....................
@@....@.............
..........@.@.@.....
.......@........@@..
@@..................
@@...@.@............
@@@@............@...
@@@@.............@..
........@...........
......@.........@...
.........@.........@
........@......@..@@
....@..@....@...@...
..@............@....
...................@
.....@....@..@....@@
..................@@
.............@....@@
..................@@
...@..............@@
18
12 7 0
8 6 0
8 18 0
4 19 0
9 19 0
0 19 0
17 8 1
3 12 1
9 8 1
13 18 1
15 6 1
17 16 1
6 13 2
8 10 2
16 11 2
2 8 2
9 3 2
17 4 2

12 6 0
9 4 0
7 18 0
4 18 0
5 13 0
4 16 0
0 18 1
18 0 1
7 4 1
1 3 1
2 4 1
18 14 1
19 6 2
6 18 2
16 14 2
16 18 2
0 15 2
1 2 2
