width 20
height 20
@.....@@.@......@@..
...........@....@...
............@..@@...
.....@..........@...
...@..@.............
@...@......@........
@......@.....@.@....
....................
............@...@...
...........@.@...@..
......@.@...........
...@..........@.....
......@........@....
.@.......@..........
....................
...@....@.....@....@
....@........@...@@@
.................@@@
@..@...@............
@...................
18
5 9 0
8 1 0
8 17 0
7 3 0
16 17 0
0 15 0
10 13 1
5 19 1
18 8 1
15 0 1
3 5 1
13 7 1
8 5 2
16 7 2
9 14 2
12 19 2
13 8 2
0 16 2

15 19 0
5 7 0
9 3 0
6 8 0
9 4 0
7 3 0
17 4 1
17 15 1
17 7 1
17 14 1
15 17 1
18 19 1
17 12 2
1 19 2
18 0 2
13 18 2
1 7 2
11 15 2
