width 20
height 20
@@..........@......@
@..................@
..@...@.............
....................
.............@......
.@..............@...
.........@@@........
...........@.......@
...............@...@
.......@....@.......
.........@.....@....
...@................
...........@..@.....
@........@..@..@....
.....@.............@
....@.....@........@
..@.........@....@..
......@.........@...
...............@....
.........@@.........
18
9 14 0
1 17 0
11 3 0
4 16 0
14 14 0
11 2 0
5 16 1
2 13 1
6 14 1
6 16 1
1 8 1
13 2 1
8 6 2
13 11 2
8 5 2
7 4 2
7 12 2
7 11 2

5 15 0
2 14 0
10 1 0
18 19 0
2 1 0
3 16 0
13 14 1
16 1 1
18 2 1
14 6 1
0 8 1
14 18 1
10 3 2
14 9 2
19 13 2
13 7 2
19 10 2
6 12 2
