width 20
height 20
@@............@.....
..............@.....
...............@....
..........@..@......
@........@..@.......
....@...............
.........@......@.@.
@.@.....@...........
....@.......@.......
..@..@...@..........
........@.@.........
............@..@....
....................
.....@.@............
....................
..@....@..@..@......
...@....@...........
.....@.............@
@@.................@
@@.......@@......@.@
18
3 18 0
2 6 0
19 0 0
19 3 0
3 13 0
11 11 0
5 3 1
19 2 1
3 2 1
18 15 1
17 18 1
9 3 1
14 12 2
17 10 2
18 17 2
15 17 2
5 7 2
5 8 2

2 5 0
3 0 0
18 2 0
16 19 0
3 13 0
12 17 0
18 17 1
11 13 1
3 2 1
9 11 1
18 10 1
8 8 1
16 0 2
5 6 2
12 5 2
17 12 2
16 3 2
6 10 2
