width 20
height 20
@.....@....@@.......
@.....@......@...@..
@..@................
@...............@...
.....@..............
..@.....@@..........
.@................@.
........@....@......
..@.......@.......@.
..........@...@.....
................@...
....@...............
...@.........@..@...
.................@..
..........@.........
....@.......@....@..
......@....@..@.....
@...............@...
@...................
@...................
18
1 19 0
18 13 0
7 7 0
3 8 0
11 2 0
16 1 0
7 19 1
15 17 1
12 8 1
7 1 1
18 15 1
5 8 1
1 14 2
6 7 2
11 17 2
14 5 2
9 17 2
12 17 2

13 8 0
15 17 0
19 1 0
5 19 0
13 0 0
12 10 0
8 15 1
6 5 1
11 7 1
16 19 1
11 6 1
5 10 1
1 7 2
19 15 2
1 1 2
4 19 2
5 0 2
2 16 2
