width 20
height 20
....................
.........@..........
...........@.@@@@...
......@.@.@...@@@.@.
...@...@............
..@.......@.....@...
.......@............
..........@...@.@...
......@...........@.
..@..@......@.......
...@......@..@......
.@..............@...
.....@........@..@..
.........@..........
..@.............@...
..@.......@......@..
.....@..@...........
............@.......
.@.@................
....................
18
2 2 0
2 18 0
6 6 0
4 5 0
5 17 0
3 12 0
9 9 1
18 9 1
18 0 1
19 13 1
2 3 1
4 8 1
4 16 2
13 17 2
2 11 2
9 19 2
6 4 2
7 9 2

2 0 0
17 2 0
3 17 0
16 16 0
18 0 0
3 1 0
12 12 1
15 8 1
4 6 1
0 0 1
19 19 1
19 17 1
12 7 2
2 7 2
16 0 2
7 11 2
11 11 2
17 19 2
