width 20
height 20
@@..............@@..
...........@.@......
.........@.....@....
....@...............
......@.......@.....
.................@@.
.......@.@.@........
....@...............
..........@...@.....
......@.@...........
@.@.................
@@.........@...@....
.....@...@..........
.................@..
....................
......@....@.@......
..@..@............@.
@@..................
@@.......@@@........
@@....@@@@@....@....
18
4 10 0
10 6 0
15 10 0
8 13 0
0 1 0
6 7 0
13 14 1
16 13 1
3 7 1
12 7 1
19 14 1
9 8 1
0 12 2
8 1 2
1 12 2
10 0 2
16 11 2
14 16 2

13 0 0
9 1 0
12 12 0
10 16 0
9 3 0
18 0 0
3 6 1
4 0 1
19 18 1
12 0 1
10 3 1
14 12 1
18 2 2
7 14 2
19 3 2
18 10 2
0 16 2
11 5 2
