width 20
height 20
@..@................
...........@..@.....
....................
.....@..@..@........
....................
........@...........
...............@...@
@...................
@.....@..@..........
@@..@............@..
..@..@....@.........
..................@.
.............@......
...........@..@...@.
..@........@...@....
...@..@.@...........
....@..........@....
.........@...@...@..
....................
....................
18
13 7 0
4 6 0
0 2 0
18 8 0
16 2 0
7 0 0
3 1 1
8 19 1
10 5 1
8 13 1
18 14 1
16 3 1
9 9 2
3 9 2
15 3 2
0 5 2
14 4 2
7 12 2

7 19 0
16 14 0
17 3 0
0 19 0
10 18 0
5 2 0
0 2 1
18 19 1
11 19 1
1 5 1
4 0 1
7 14 1
2 15 2
0 10 2
13 4 2
8 7 2
9 3 2
14 5 2
