width 20
height 20
..@@................
....................
.......@............
...@.........@.@....
....................
..@........@..@.....
.....@...@..........
....@...............
.@......@..@........
@............@......
....@...@.@@..@.....
....................
......@.@...........
........@..@........
.@..............@...
........@.@..@.@....
.........@..........
.......@.......@...@
....................
..@.@@..............
18
4 12 0
17 16 0
5 13 0
19 2 0
19 7 0
18 6 0
4 15 1
5 9 1
3 14 1
18 16 1
0 18 1
17 6 1
18 15 2
7 18 2
9 2 2
4 8 2
0 7 2
1 15 2

17 1 0
0 11 0
5 11 0
0 18 0
1 18 0
2 11 0
17 17 1
19 15 1
19 2 1
2 4 1
16 11 1
16 3 1
9 7 2
9 5 2
14 8 2
4 8 2
15 18 2
17 8 2
