width 20
height 20
@.........@.........
@...................
....................
.......@........@...
..@.................
...@........@..@@...
...................@
....................
...........@........
....@........@......
................@...
...@................
......@.....@.......
@...................
..@...............@@
...@..@.@....@...@..
..@.................
............@.......
................@...
@...@@..............
18
5 13 0
8 12 0
19 7 0
10 1 0
18 3 0
18 1 0
19 4 1
15 6 1
17 1 1
8 10 1
15 11 1
13 16 1
10 19 2
10 10 2
1 4 2
12 19 2
19 3 2
7 5 2

5 13 0
17 0 0
17 10 0
11 5 0
13 3 0
2 18 0
7 0 1
5 12 1
9 17 1
13 0 1
5 0 1
18 4 1
10 6 2
19 1 2
6 7 2
13 4 2
19 11 2
6 5 2
