width 20
height 20
....................
@..........@........
.............@......
.@.......@..@.......
...................@
@.........@...@.....
..@...@..........@@@
.................@@@
.................@@@
....@...@...@....@.@
....................
....@..@......@.....
......@.............
.........@.@...@....
..@.......@......@..
......@...........@.
.........@..........
.......@...@...@....
....................
....................
18
5 18 0
13 9 0
19 2 0
4 6 0
10 16 0
17 1 0
19 13 1
2 0 1
13 1 1
19 19 1
6 0 1
1 7 1
15 0 2
4 3 2
10 19 2
2 13 2
18 16 2
9 18 2

10 15 0
2 18 0
19 10 0
7 10 0
8 15 0
0 18 0
18 17 1
9 14 1
1 19 1
2 2 1
16 2 1
16 6 1
4 5 2
12 14 2
12 4 2
18 3 2
13 17 2
9 17 2
