width 20
height 20
................@@@@
.........@.......@..
............@..@....
.....@.@............
........@.@..@......
...@................
...............@....
......@.......@.....
....................
.@......@..@....@...
...@................
..............@.....
......@..@..........
..@.....@..........@
...........@..@.....
....@.@.........@@..
...........@..@.@@..
.@...@@......@..@...
....................
....@.....@@...@....
18
9 14 0
0 17 0
9 13 0
16 1 0
0 4 0
5 6 0
17 2 1
5 11 1
19 9 1
0 14 1
15 8 1
12 11 1
3 9 2
5 18 2
5 4 2
2 9 2
19 15 2
1 0 2

3 3 0
0 19 0
4 2 0
15 11 0
4 9 0
10 10 0
2 12 1
8 1 1
12 9 1
11 1 1
19 6 1
6 8 1
9 16 2
3 4 2
10 3 2
10 15 2
0 7 2
15 0 2
