width 20
height 20
.................@@@
.@...............@..
...........@........
...@...@.@..........
@............@.@...@
..@.................
....................
.............@......
......@..@.....@.@..
...@................
.....@........@.....
.............@......
.@...@.............@
.........@..........
....................
.....@.@........@...
....................
@@.......@..@.......
@@....@.............
@@..................
18
10 5 0
12 15 0
0 14 0
3 17 0
11 15 0
17 14 0
17 9 1
3 6 1
5 17 1
12 1 1
9 2 1
17 17 1
1 2 2
7 18 2
18 9 2
9 18 2
1 4 2
2 10 2

10 4 0
12 16 0
11 19 0
16 16 0
1 0 0
15 3 0
12 4 1
19 19 1
6 4 1
4 15 1
10 8 1
17 5 1
14 19 2
19 6 2
8 19 2
12 3 2
9 10 2
14 3 2
