width 20
height 20
@@@@@@@@@........@..
@@@@@@@@............
@@@@@@@@....@.......
..@@@.@@.@.@..@.....
.............@......
....................
...........@.@....@.
.@....@.......@.....
....................
......@.@...........
....@..@......@.....
.....@..............
...@................
.............@...@.@
........@...........
..@.......@......@..
....@..@............
...........@........
............@.......
....................
18
11 5 0
18 8 0
1 9 0
8 11 0
11 11 0
2 7 0
16 15 1
9 5 1
16 2 1
7 8 1
19 12 1
17 2 1
11 12 2
11 0 2
12 3 2
7 18 2
5 7 2
10 14 2

11 0 0
19 7 0
8 17 0
5 7 0
1 19 0
15 2 0
2 4 1
6 4 1
3 19 1
17 18 1
11 7 1
0 12 1
11 2 2
8 12 2
8 13 2
10 0 2
11 19 2
0 4 2
