width 20
height 20
....................
.......@............
...@......@......@..
....................
.@..........@....@..
..@......@..........
..........@.........
.....@...@..........
..............@.....
....................
.@..@.@.............
....................
.@...............@..
.........@..........
.@...@........@.....
@....@.@...........@
@@......@....@...@.@
@@.................@
...........@.......@
@..@...............@
18
17 19 0
15 11 0
1 9 0
17 5 0
6 8 0
16 15 0
18 8 1
4 4 1
8 17 1
5 10 1
16 14 1
8 2 1
8 15 2
1 8 2
19 11 2
2 18 2
10 15 2
1 11 2

2 0 0
16 8 0
16 18 0
16 2 0
18 15 0
19 13 0
5 2 1
19 8 1
19 0 1
14 1 1
18 14 1
9 1 1
8 6 2
15 2 2
10 3 2
4 16 2
2 1 2
14 5 2
