width 20
height 20
..........@@@@@.....
...........@@..@.@..
..@.................
....................
.........@.....@....
......@..@@.@.......
..................@.
...@..........@.....
.@.........@...@....
................@...
....................
.......@.....@......
....................
.@..@......@........
.......@............
.@..@...............
.......@.@.....@....
................@@@@
............@...@@@@
.....@..........@@@@
18
0 15 0
14 4 0
2 0 0
2 7 0
7 1 0
8 6 0
13 12 1
14 6 1
2 18 1
11 9 1
18 15 1
19 12 1
12 8 2
1 19 2
10 12 2
3 12 2
5 5 2
6 0 2

13 8 0
15 12 0
0 15 0
9 0 0
7 2 0
3 17 0
6 14 1
9 7 1
18 4 1
16 1 1
17 3 1
17 10 1
4 17 2
12 6 2
10 11 2
19 0 2
17 16 2
19 14 2
