width 20
height 20
....................
...............@....
...@......@.........
..............@.....
..@...@.............
........@..@...@....
@...............@...
....@...............
.......@.@..........
....................
....@...............
.@.....@...@..@.....
...............@..@.
.......@@...........
....................
......@..@..........
.@..............@...
......@...@..@......
....................
.@@.................
18
10 0 0
18 7 0
10 14 0
1 15 0
8 6 0
2 9 0
16 14 1
0 3 1
17 11 1
19 12 1
19 7 1
19 6 1
1 6 2
12 7 2
13 9 2
16 0 2
10 19 2
12 16 2

15 18 0
16 4 0
8 3 0
3 15 0
15 19 0
19 17 0
0 2 1
12 6 1
17 11 1
3 17 1
14 15 1
0 18 1
14 6 2
4 0 2
1 5 2
1 14 2
9 17 2
1 1 2
