width 20
height 20
@.................@.
............@.......
...............@.@..
....@...............
...............@....
@.@...@......@......
.........@..........
@....@......@......@
@.@................@
@......@............
@...................
...@........@.......
..........@.........
.........@..........
.............@......
....@@......@.@.@@..
....................
.......@...@..@.....
....................
....................
18
0 2 0
12 16 0
7 18 0
14 8 0
3 5 0
0 4 0
13 15 1
0 3 1
2 13 1
5 8 1
7 12 1
13 3 1
15 14 2
17 18 2
4 18 2
15 11 2
3 4 2
1 10 2

18 12 0
3 4 0
1 10 0
0 1 0
15 6 0
5 2 0
13 15 1
1 14 1
19 1 1
11 6 1
19 2 1
1 8 1
8 5 2
14 8 2
15 7 2
6 2 2
18 18 2
19 0 2
