width 20
height 20
........@..........@
....................
.........@.........@
.@....@@.@.......@..
......@@............
......@@....@..@....
..@....@............
..........@..@......
....@..@.....@......
....................
.....@.....@........
..........@...@.@...
....................
..............@...@.
@.@............@....
@..@...@..........@.
..@........@........
....................
.@..................
@@.........@@@......
18
2 1 0
15 15 0
14 4 0
14 9 0
8 4 0
4 14 0
15 11 1
3 18 1
10 1 1
14 16 1
13 15 1
12 4 1
16 19 2
11 4 2
5 6 2
0 12 2
4 19 2
1 14 2

0 2 0
19 9 0
19 3 0
5 11 0
15 18 0
11 17 0
3 8 1
18 5 1
15 4 1
11 7 1
14 17 1
6 1 1
9 15 2
1 14 2
5 7 2
4 6 2
17 2 2
16 7 2
