width 20
height 20
@......@............
@@..........@.......
.........@..........
..@.........@.......
...@.....@@....@....
..@....@..@.........
...............@...@
..@...@.............
@@..............@...
@@..@.............@.
@@........@.........
......@.........@...
..@.@...........@...
....................
.......@............
@@....@....@........
@..@............@...
...@..@.............
.........@.....@....
....................
18
19 15 0
7 11 0
17 7 0
8 11 0
13 4 0
13 0 0
4 2 1
10 0 1
4 1 1
9 1 1
11 10 1
11 16 1
7 16 2
3 18 2
12 10 2
11 9 2
2 15 2
10 13 2

1 2 0
7 16 0
2 11 0
9 7 0
13 1 0
19 16 0
17 19 1
3 2 1
0 2 1
14 6 1
11 10 1
17 11 1
19 8 2
9 0 2
14 10 2
11 7 2
19 10 2
19 1 2
