width 20
height 20
@@@.............@@@@
@@@.............@@@@
@@@@@.@..@......@@@@
@@..@.@.............
............@.......
...@...@..@.........
.....@..........@...
...@......@..@...@..
@@...@........@.....
....@......@....@.@.
.....@..............
....................
....@...........@..@
.@......@..........@
....................
...@.@......@.......
.........@.@.@......
.@..................
................@...
....@@..@.@@.......@
18
18 7 0
11 0 0
14 11 0
10 14 0
6 0 0
13 15 0
15 12 1
1 12 1
7 15 1
19 4 1
17 8 1
13 3 1
5 14 2
12 7 2
9 7 2
7 10 2
3 11 2
11 12 2

3 19 0
10 13 0
8 2 0
3 0 0
7 1 0
1 19 0
0 16 1
14 4 1
15 3 1
3 6 1
0 17 1
3 17 1
19 3 2
9 14 2
0 4 2
5 13 2
3 10 2
17 14 2
