width 20
height 20
@..........@.@@@....
@.....@.............
........@..@........
....................
........@...........
............@.......
..................@@
....@.@..@.@.....@@@
..............@..@@@
.......@............
@..@........@.......
............@.....@.
............@.@.@...
....................
.....@.....@.@......
.@..@...........@...
.............@......
...@................
......@.@..@........
....................
18
2 19 0
6 9 0
12 9 0
12 3 0
13 9 0
11 5 0
8 19 1
8 3 1
10 9 1
13 11 1
5 1 1
4 2 1
1 18 2
6 19 2
19 15 2
14 14 2
16 7 2
17 6 2

9 5 0
18 9 0
2 5 0
5 0 0
16 11 0
5 2 0
18 0 1
13 8 1
12 13 1
1 19 1
10 15 1
18 3 1
17 12 2
13 4 2
19 16 2
2 11 2
15 19 2
1 1 2
