width 20
height 20
@@..................
....................
......@..@..........
..@.........@.....@.
............@.......
...............@....
...........@........
........@...........
................@...
.............@......
..............@.....
...@...@....@.......
....................
....@.........@.....
.........@.......@..
............@.......
......@.............
.....@........@.@...
...@@..@.......@@...
...@@..........@@...
18
5 15 0
17 10 0
11 1 0
19 17 0
19 13 0
7 6 0
14 12 1
12 19 1
2 11 1
5 4 1
15 4 1
5 14 1
12 7 2
4 8 2
15 11 2
16 3 2
14 9 2
13 2 2

19 0 0
0 1 0
10 17 0
2 10 0
11 8 0
8 6 0
1 3 1
10 13 1
2 11 1
4 9 1
2 16 1
18 6 1
1 19 2
16 3 2
16 6 2
2 17 2
15 9 2
13 15 2
