width 20
height 20
@@.......@@@@@@....@
@@.......@@@@@@@....
@..@.....@@@@@@@....
@.....@...@@@@@.....
....@......@@@......
....................
@.......@.....@.....
@........@.@...@....
@...@.....@.....@...
...@...........@.@..
...@..@.......@.....
....................
...@................
.....@..............
.@......@...........
..........@.....@...
...................@
........@...........
..............@.....
@...................
18
4 12 0
0 9 0
1 2 0
16 17 0
10 17 0
11 8 0
9 14 1
16 3 1
6 9 1
4 10 1
7 13 1
13 9 1
3 19 2
1 13 2
2 9 2
0 14 2
1 3 2
7 12 2

18 9 0
19 18 0
3 6 0
2 2 0
6 8 0
1 15 0
13 8 1
12 10 1
15 13 1
5 9 1
17 1 1
1 18 1
14 11 2
19 4 2
4 11 2
19 5 2
5 17 2
18 2 2
