width 20
height 20
....................
....................
..................@.
....@.........@.....
........@.......@...
.@.@........@.......
....@.@.@...........
.....@.@..@.........
...................@
....@...............
..@..@........@....@
......@...@........@
...@................
.........@...@......
...........@........
...@.@..@......@....
....@.........@.....
.........@..........
.......@............
....................
18
6 17 0
3 8 0
18 0 0
7 3 0
8 0 0
3 18 0
13 5 1
11 13 1
12 9 1
0 15 1
17 12 1
3 2 1
12 4 2
6 10 2
0 0 2
7 12 2
9 7 2
16 3 2

7 3 0
19 18 0
16 3 0
7 16 0
8 0 0
17 14 0
16 18 1
10 6 1
2 12 1
0 14 1
18 13 1
6 4 1
12 14 2
19 19 2
7 11 2
10 12 2
6 19 2
1 17 2
