width 20
height 20
....................
............@...@...
.........@..........
.@..@...@....@......
.......@............
..........@.@.......
................@...
....@...............
..............@.....
......@..@..........
.............@...@..
.@.@..@.........@...
........@.@..@......
......@...@.....@...
@..@................
...........@.@@.....
......@......@......
..@.......@.......@.
...@................
@...................
18
7 17 0
2 14 0
18 2 0
17 8 0
15 1 0
8 8 0
13 4 1
17 11 1
18 3 1
3 13 1
17 18 1
15 5 1
9 11 2
17 19 2
16 18 2
14 17 2
1 19 2
1 8 2

7 9 0
12 0 0
15 0 0
17 4 0
8 11 0
7 7 0
12 3 1
13 11 1
5 9 1
9 7 1
17 2 1
17 3 1
10 10 2
10 9 2
4 8 2
15 18 2
6 1 2
9 3 2
