width 20
height 20
.....@......@@..@...
....................
....................
....@.@......@..@...
..............@..@..
.......@.@.....@....
...@................
....@.........@.@...
...............@....
..@.....@....@.....@
....................
...............@....
................@...
....................
......@............@
..@...........@....@
...@.@.........@@..@
....................
.........@.....@....
....................
18
19 1 0
6 15 0
0 16 0
2 8 0
12 1 0
5 14 0
7 2 1
13 7 1
5 19 1
12 9 1
10 3 1
14 11 1
6 11 2
12 6 2
10 7 2
8 8 2
15 7 2
0 0 2

14 1 0
17 17 0
9 10 0
1 9 0
3 19 0
6 1 0
18 1 1
4 0 1
19 0 1
15 13 1
0 19 1
1 2 1
15 17 2
18 16 2
1 1 2
17 19 2
4 8 2
0 1 2
