width 20
height 20
............@@.....@
......@.............
....................
....................
...............@....
.....@.............@
..............@.....
...@...............@
.@...........@......
...@.@.....@........
.............@......
..........@.........
....................
.............@.....@
.....@..........@@..
@...................
...@..@.......@.....
....................
...............@....
.....@..............
18
4 15 0
6 0 0
1 17 0
9 1 0
17 19 0
17 8 0
17 4 1
18 0 1
1 7 1
9 2 1
0 19 1
16 9 1
6 5 2
5 16 2
7 16 2
0 2 2
12 12 2
5 0 2

12 10 0
5 6 0
10 8 0
13 2 0
12 18 0
0 19 0
10 15 1
13 17 1
2 4 1
10 17 1
1 14 1
1 9 1
1 12 2
2 11 2
6 15 2
5 13 2
13 12 2
1 4 2
