width 20
height 20
..........@@@@......
.....@..............
........@...........
..................@.
..............@.....
.............@......
...........@....@...
.........@..@.......
.................@..
....@......@....@...
..........@.@.......
...@.....@..........
.............@......
......@.@......@....
.....@..............
.@.......@..........
@@..................
@...@.........@@...@
@.....@@@..@..@@...@
@.................@@
18
16 4 0
8 10 0
12 14 0
17 14 0
4 0 0
14 9 0
14 11 1
6 9 1
10 13 1
17 5 1
7 13 1
1 1 1
12 1 2
10 8 2
4 7 2
16 12 2
6 5 2
18 12 2

16 5 0
3 0 0
12 5 0
2 4 0
5 0 0
5 18 0
18 6 1
19 0 1
10 7 1
17 3 1
16 17 1
16 12 1
17 12 2
14 13 2
16 13 2
16 3 2
19 15 2
2 5 2
