width 20
height 20
...................@
..............@....@
...................@
.@........@.....@...
......@.@......@....
@...................
@..........@........
@@@.............@...
@@@........@.....@..
@@@...@..@........@@
@@....@@..........@@
@@......@...@.@.@...
......@...@.........
.....@.....@....@...
@...................
.........@........@.
..........@.........
...@@...............
....@@@.@..@........
....@@@.............
18
2 5 0
13 3 0
5 12 0
3 14 0
13 6 0
12 6 0
5 15 1
4 3 1
9 16 1
4 0 1
2 10 1
5 16 1
13 1 2
18 13 2
2 6 2
4 9 2
5 17 2
14 12 2

14 16 0
19 8 0
13 0 0
7 13 0
12 8 0
17 0 0
1 18 1
11 5 1
16 1 1
1 17 1
19 13 1
18 0 1
3 14 2
18 12 2
19 19 2
4 9 2
1 2 2
7 3 2
