width 20
height 20
............@.......
..@.................
.@......@.......@...
............@.......
.....@........@...@.
.....@...........@..
@@..................
...@...........@....
....@............@..
..@.....@..@@.....@.
...............@....
.................@..
..@...@....@........
.............@......
.@....@....@........
....................
....................
....@...@..@........
........@...........
................@@@@
18
6 1 0
9 16 0
16 12 0
12 4 0
11 0 0
18 17 0
2 11 1
13 19 1
8 5 1
10 18 1
11 13 1
13 15 1
6 5 2
2 18 2
15 14 2
19 3 2
5 15 2
0 11 2

7 4 0
4 1 0
16 14 0
1 18 0
0 19 0
17 4 0
9 18 1
11 13 1
12 19 1
13 17 1
14 9 1
17 2 1
5 8 2
3 6 2
2 0 2
5 0 2
6 16 2
14 0 2
