width 20
height 20
........@@..........
.........@..........
....@.@......@......
....................
.........@........@.
....@...........@...
....................
.........@..........
......@.....@..@....
....................
..@........@.@..@...
...@.@..@...........
....................
...........@.@......
....@@........@.....
..........@....@....
....@......@....@@..
.....@.........@@@@@
................@@@@
................@@@@
18
10 13 0
8 19 0
18 14 0
7 8 0
8 17 0
7 2 0
7 4 1
0 14 1
10 4 1
2 0 1
15 10 1
10 18 1
9 17 2
1 9 2
6 10 2
12 15 2
12 14 2
0 16 2

6 11 0
18 1 0
2 14 0
7 8 0
10 5 0
15 0 0
10 13 1
5 18 1
11 2 1
17 5 1
8 3 1
16 11 1
6 10 2
18 15 2
16 0 2
11 0 2
10 7 2
8 18 2
