width 20
height 20
....................
...@...........@....
....................
....@...............
........@.@.........
......@..@.@........
..@.................
....................
.....@....@.........
.............@......
....................
.....@.....@....@...
.......@............
.............@..@...
........@...@.@.....
.....@..............
....@.........@.....
.....@..............
......@....@........
.........@..........
18
0 7 0
11 12 0
4 12 0
13 16 0
8 18 0
6 0 0
4 6 1
12 13 1
2 2 1
14 9 1
17 12 1
16 10 1
5 2 2
13 10 2
2 7 2
13 8 2
10 17 2
10 3 2

8 8 0
12 16 0
17 0 0
9 18 0
3 2 0
11 0 0
10 10 1
11 15 1
12 12 1
10 5 1
5 2 1
14 1 1
1 2 2
14 6 2
19 8 2
13 6 2
13 0 2
14 19 2
