width 20
height 20
....................
....................
....................
.....@......@.@.....
@.......@..@...@....
@.@.............@...
@.........@.........
@..@.......@.@...@..
......@...@.@.......
....................
...@....@.......@.@.
.....@......@.......
....................
....................
@..@..@.............
@@.....@.@.@.....@..
@@..................
@@@.@.........@.....
@..........@..@.....
@.................@@
18
10 19 0
16 19 0
11 3 0
7 7 0
5 8 0
3 9 0
16 13 1
8 2 1
14 2 1
1 7 1
7 13 1
7 17 1
16 14 2
0 10 2
4 11 2
15 1 2
6 17 2
12 14 2

2 10 0
16 19 0
18 16 0
1 8 0
4 2 0
11 13 0
3 16 1
16 13 1
8 2 1
1 6 1
7 13 1
18 0 1
6 4 2
7 12 2
6 5 2
5 17 2
5 4 2
9 0 2
