width 20
height 20
.....@@@@@@@........
......@@............
.....@@@...........@
..@...........@.@..@
.................@.@
..............@..@@@
....................
...........@@.......
......@....@....@...
@..........@@.......
...............@....
.......@..@.........
...@................
.........@.@........
.....@........@..@..
..@............@....
...@..@.@...........
....@.........@.....
...@......@.........
....................
18
17 13 0
10 6 0
18 2 0
5 3 0
6 10 0
3 8 0
5 11 1
10 5 1
11 17 1
8 6 1
19 18 1
4 12 1
2 0 2
14 9 2
12 5 2
15 5 2
14 13 2
0 12 2

6 17 0
1 0 0
11 11 0
1 6 0
19 1 0
6 19 0
18 3 1
10 6 1
19 6 1
1 15 1
18 19 1
19 8 1
0 5 2
0 11 2
18 11 2
5 3 2
5 19 2
14 6 2
