width 20
height 20
@.............@....@
.........@.....@....
....................
................@...
....@.@.............
.................@..
........@....@......
..@...@.............
..@.................
.....@...@.@.@...@@.
..........@.@.......
..............@.....
....@......@....@...
....@...............
....@...@..@........
.........@.....@....
....................
....................
....@...............
...............@....
18
2 12 0
10 7 0
9 18 0
5 16 0
18 3 0
18 4 0
3 19 1
16 6 1
7 11 1
15 17 1
3 13 1
5 3 1
12 11 2
5 19 2
0 16 2
18 2 2
19 7 2
6 0 2

3 13 0
19 2 0
9 13 0
18 0 0
0 1 0
4 19 0
3 18 1
3 12 1
18 1 1
19 8 1
1 17 1
18 18 1
0 15 2
15 3 2
6 5 2
0 19 2
10 17 2
18 5 2
