width 20
height 20
@@.........@........
..........@.........
.......@............
....................
....................
..............@.....
....@...@........@..
...@.........@......
..........@.........
........@@@@........
........@@......@..@
...@......@.........
...........@........
....................
..........@...@..@..
.....@......@.......
@.....@.............
@..........@........
@.........@.........
.......@@...........
18
17 4 0
19 9 0
0 1 0
15 0 0
14 1 0
18 7 0
2 10 1
14 11 1
16 3 1
16 14 1
14 2 1
3 2 1
2 5 2
12 19 2
7 0 2
17 18 2
13 2 2
2 19 2

19 6 0
2 15 0
3 6 0
1 14 0
10 6 0
7 13 0
15 18 1
6 17 1
17 13 1
7 10 1
17 17 1
19 2 1
3 5 2
11 15 2
10 3 2
3 8 2
8 11 2
3 19 2
