width 20
height 20
....................
..............@.....
....................
...@..@...@.........
.......@.@...@......
.............@....@.
.........@.......@..
..@.................
.......@....@....@..
.....@...........@..
...........@........
...@................
......@........@....
....@.........@.....
...............@....
..............@.....
...@...@....@.......
....................
.................@..
...................@
18
17 11 0
2 1 0
16 13 0
15 1 0
17 7 0
19 4 0
8 9 1
0 9 1
3 4 1
15 19 1
9 12 1
4 5 1
1 1 2
9 17 2
12 0 2
14 17 2
0 1 2
2 12 2

5 18 0
8 1 0
9 7 0
6 15 0
16 10 0
7 5 0
17 11 1
1 15 1
14 18 1
15 10 1
4 6 1
0 17 1
5 12 2
9 17 2
3 14 2
10 2 2
0 2 2
7 6 2
