width 20
height 20
.....@@.............
..............@.....
.........@..........
...@@...............
..............@.....
..@....@............
.........@@......@..
..........@..@......
.......@.........@..
....................
.@...@.......@......
.................@..
....@...............
....................
..@....@...@....@...
.....@......@.......
.....@.........@....
.......@............
................@...
.............@@.....
18
3 11 0
7 4 0
14 18 0
2 17 0
4 6 0
18 1 0
10 8 1
5 12 1
16 8 1
6 9 1
7 6 1
12 18 1
2 11 2
5 5 2
9 9 2
18 19 2
0 2 2
6 5 2

19 14 0
6 3 0
12 17 0
10 9 0
5 6 0
19 4 0
18 19 1
4 5 1
19 12 1
3 7 1
4 9 1
13 4 1
2 11 2
16 3 2
1 19 2
8 15 2
15 18 2
16 10 2
