width 20
height 20
@@................@.
@.......@.........@.
....................
....................
....@.......@..@..@.
......@.............
@.......@..@...@....
.............@....@.
......@.....@...@@..
..@.................
.........@..........
.....@......@..@.@..
....................
..@......@...@......
......@.............
.........@....@.....
..@.................
......@.....@.......
....................
@@@................@
18
9 0 0
5 10 0
14 11 0
4 19 0
1 4 0
8 16 0
6 13 1
7 12 1
19 16 1
16 5 1
14 7 1
9 7 1
1 3 2
16 19 2
10 13 2
10 0 2
8 7 2
1 10 2

13 1 0
15 0 0
8 10 0
8 4 0
18 12 0
18 5 0
12 3 1
19 16 1
18 17 1
1 15 1
5 15 1
3 8 1
15 18 2
4 18 2
17 2 2
1 12 2
15 17 2
19 1 2
