width 20
height 20
...@....@...........
@@..@.......@.......
................@..@
....@...@..@..@....@
...@................
.....@..@.....@.....
.@.@.@..............
...........@.....@..
....@...............
....................
......@.........@...
....................
.@.@........@..@....
....................
......@....@....@...
.........@..........
....................
.@..@.........@.....
....................
.......@.......@@@..
18
0 6 0
12 6 0
5 4 0
12 11 0
16 1 0
12 2 0
9 16 1
17 15 1
12 3 1
4 5 1
16 0 1
7 4 1
11 5 2
13 17 2
17 8 2
3 15 2
10 1 2
14 2 2

4 11 0
11 4 0
9 11 0
1 0 0
12 8 0
7 17 0
19 1 1
17 15 1
0 15 1
4 5 1
17 12 1
17 18 1
19 18 2
3 2 2
6 5 2
10 3 2
14 6 2
7 2 2
