width 20
height 20
....................
....................
.......@.......@....
.....@..............
....@...............
.@@.....@.......@...
.......@............
............@....@..
....................
.................@..
.@....@...@.....@...
.........@@..@......
...@.@.......@......
@@.............@....
....@...........@...
.....@.@............
........@..@....@...
...@..............@@
....@..............@
................@@@@
18
1 15 0
10 17 0
11 5 0
17 13 0
15 5 0
2 9 0
19 4 1
15 6 1
17 11 1
2 19 1
19 3 1
12 3 1
9 9 2
0 19 2
8 7 2
1 4 2
8 10 2
19 16 2

16 0 0
15 16 0
10 5 0
1 3 0
16 15 0
19 0 0
16 18 1
3 19 1
9 3 1
15 5 1
19 2 1
8 18 1
10 8 2
4 6 2
14 4 2
1 4 2
0 4 2
3 13 2
