width 20
height 20
@................@@@
@................@@@
@.......@@........@@
@..............@...@
.....@..@..........@
.@........@..@......
...............@.@..
.....@..............
..............@@....
.@..@....@..........
.@..................
@.....@........@....
..............@...@.
......@..@.....@....
.......@.........@..
...@......@.........
....@...............
.....@...@.....@@...
@..............@@@..
@..........@@@...@..
18
10 6 0
12 7 0
14 6 0
1 11 0
12 11 0
3 0 0
15 7 1
9 7 1
7 6 1
5 5 1
8 11 1
3 8 1
13 14 2
7 9 2
16 12 2
1 13 2
6 3 2
7 2 2

19 19 0
14 5 0
17 9 0
15 12 0
19 6 0
16 8 0
2 19 1
11 1 1
7 12 1
19 17 1
9 10 1
6 0 1
6 9 2
15 16 2
2 1 2
11 16 2
0 4 2
3 17 2
