width 20
height 20
....................
@...............@...
...@...........@....
....................
.....@@.............
...@....@.@.........
.................@..
....@...............
.................@..
............@.......
.............@......
.@....@.............
............@......@
....@.@.......@....@
..@.....@...........
....................
...@...@.....@.@@...
.........@..........
....@...@.@.@.......
...................@
18
7 9 0
11 8 0
16 5 0
14 0 0
17 2 0
14 19 0
16 2 1
9 13 1
3 7 1
11 16 1
6 16 1
2 5 1
15 15 2
17 12 2
18 0 2
0 16 2
2 11 2
15 8 2

8 7 0
5 9 0
9 5 0
5 14 0
14 11 0
7 2 0
0 12 1
10 15 1
18 15 1
4 4 1
18 4 1
10 9 1
3 11 2
17 12 2
15 1 2
18 12 2
2 11 2
4 1 2
