width 20
height 20
.@@......@........@@
..@.................
@....@...@..........
@..@..@.....@...@...
...........@.......@
....................
...........@......@.
.......@.@..........
....@.........@....@
.............@......
.....@.@..@.@.......
..@..........@......
........@........@..
....@...............
......@...@..@...@..
....................
..@.@...@......@..@.
....................
..@....@...@........
..............@.....
18
0 13 0
2 5 0
3 16 0
3 14 0
12 13 0
10 8 0
13 1 1
19 3 1
11 5 1
2 4 1
8 19 1
19 17 1
19 10 2
5 18 2
10 6 2
16 4 2
4 2 2
6 5 2

17 3 0
14 2 0
9 18 0
11 12 0
12 6 0
1 15 0
16 11 1
8 9 1
10 1 1
5 14 1
17 2 1
18 17 1
14 13 2
5 17 2
0 18 2
3 17 2
2 8 2
1 1 2
