width 20
height 20
....................
......@.............
.@@....@............
@@@..........@.@..@.
@...................
@...................
@......@......@.....
....................
....@....@....@.....
...........@........
@...........@.@.....
@@...@.......@......
@@.@................
@@..................
@.......@........@..
@@...............@..
@..........@......@.
....................
..@..@..............
.@@.@........@......
18
3 17 0
12 8 0
5 4 0
10 8 0
16 11 0
15 9 0
1 10 1
16 8 1
2 9 1
3 11 1
5 14 1
13 10 1
13 5 2
9 9 2
5 15 2
10 16 2
19 5 2
19 3 2

2 15 0
10 8 0
8 13 0
19 19 0
10 0 0
3 0 0
1 0 1
1 16 1
9 13 1
19 16 1
19 5 1
4 12 1
0 18 2
6 7 2
8 16 2
6 4 2
3 18 2
4 13 2
