width 20
height 20
@..................@
@.............@.....
..@..........@......
..........@...@.....
.@.....@........@...
............@.....@.
.......@...@...@....
.........@..........
....@..........@....
...@...@.@.........@
.@..................
....................
....@..@.........@..
........@.@.........
....................
..@...............@.
....@....@..........
.....@....@.........
..............@.....
.........@.@........
18
7 3 0
13 0 0
16 15 0
3 15 0
12 10 0
6 0 0
15 19 1
11 12 1
15 16 1
16 8 1
8 14 1
13 17 1
10 18 2
9 3 2
6 3 2
4 4 2
0 4 2
1 1 2

16 16 0
13 17 0
12 3 0
18 4 0
3 5 0
8 18 0
2 11 1
14 2 1
9 5 1
15 12 1
1 3 1
13 15 1
2 0 2
12 15 2
9 4 2
5 4 2
12 17 2
16 13 2
