width 20
height 20
...........@@@......
.@.......@..@@......
....................
...@.............@..
....@@..............
.@.......@......@...
...........@..@.....
..@.@...............
.....@..............
.......@.......@....
...@....@.@.........
....@........@......
...........@......@.
.....@..............
.......@.........@..
....................
...@........@.......
..........@.........
....@...............
@@@.................
18
3 8 0
6 0 0
8 11 0
19 4 0
13 6 0
16 9 0
8 1 1
16 11 1
15 18 1
14 4 1
7 4 1
11 14 1
3 14 2
10 14 2
18 9 2
11 7 2
8 15 2
3 0 2

1 16 0
3 8 0
19 14 0
7 7 0
9 4 0
17 6 0
15 19 1
13 6 1
15 18 1
17 4 1
19 18 1
12 5 1
1 4 2
12 19 2
16 13 2
10 8 2
13 3 2
8 1 2
