width 20
height 20
..@@.............@@@
...@...............@
....................
......@.@...........
..........@....@....
....................
.............@......
@....@..@.@.........
...................@
.....@...........@.@
......@..@..@......@
.............@......
..@...@...........@.
.........@@...@@....
...........@..@@....
........@.....@@....
@..@.........@@@.@..
@...@........@......
@...................
@...@.....@....@@...
18
3 6 0
9 1 0
8 12 0
4 8 0
1 16 0
14 17 0
4 5 1
11 10 1
19 4 1
15 0 1
5 12 1
13 18 1
15 6 2
3 19 2
12 7 2
18 16 2
11 8 2
5 15 2

12 17 0
13 19 0
12 15 0
1 12 0
0 9 0
7 15 0
9 3 1
11 9 1
1 15 1
16 1 1
16 9 1
14 8 1
18 5 2
17 4 2
9 4 2
2 9 2
15 10 2
15 2 2
