width 20
height 20
..........@.........
....................
................@...
@.......@..@........
............@....@@@
.....@............@@
............@.......
...@....@.....@.....
.......@..........@.
..@.................
...@...@.....@......
......@.@..@........
....@...............
..@......@..........
.......@....@...@...
....@.............@.
...@....@..@..@.....
.............@......
......@.............
................@@@.
18
17 0 0
5 3 0
17 9 0
1 12 0
6 6 0
18 17 0
14 14 1
17 7 1
16 10 1
12 16 1
12 8 1
12 5 1
17 1 2
14 13 2
19 2 2
19 6 2
6 8 2
15 19 2

3 9 0
16 13 0
5 14 0
13 3 0
19 17 0
5 18 0
6 8 1
19 8 1
2 7 1
12 0 1
18 14 1
9 4 1
7 7 2
17 17 2
7 16 2
19 7 2
9 5 2
15 5 2
