width 20
height 20
@..................@
@..........@.......@
....................
.....@..@..@........
...................@
...@...@.......@....
.@.......@..........
...@.............@..
..@.................
...........@...@....
.........@..........
................@..@
.............@......
..............@.....
@...@....@..@.......
.....@.............@
....................
.......@............
.........@.......@..
..@.................
18
18 9 0
10 3 0
17 2 0
1 17 0
18 18 0
15 19 0
11 0 1
15 0 1
10 13 1
13 5 1
0 6 1
1 14 1
11 7 2
10 18 2
8 7 2
1 15 2
8 10 2
16 1 2

15 1 0
2 12 0
17 2 0
13 6 0
11 14 0
7 0 0
12 1 1
18 6 1
10 14 1
16 5 1
1 8 1
8 6 1
4 13 2
1 0 2
4 7 2
5 9 2
16 9 2
0 18 2
