width 20
height 20
@...@...............
......@..@..........
....................
...........@.....@..
...@.@.@....@.......
...............@..@.
....................
..@..@..............
........@...@....@..
@..............@@@@@
@....@....@....@@@@@
...............@@@@@
.................@@@
@@.....@.@..........
@@...@..............
@...........@..@....
.....@.@............
....@...@...@....@..
...........@........
@...................
18
13 6 0
18 16 0
11 5 0
18 2 0
2 8 0
6 19 0
1 1 1
12 18 1
7 9 1
4 12 1
6 3 1
6 12 1
10 11 2
13 11 2
18 0 2
13 2 2
15 12 2
14 2 2

1 19 0
14 14 0
5 13 0
10 3 0
2 4 0
15 1 0
2 3 1
0 4 1
4 13 1
18 1 1
14 0 1
10 11 1
11 0 2
19 19 2
5 15 2
13 2 2
16 14 2
9 8 2
