width 20
height 20
............@@......
.........@..@@..@.@.
....................
.....@..@...........
..@.......@...@.....
...@....@...........
.@.........@..@..@..
....................
.........@...@.@.@..
@.@..@..............
@...............@...
....................
...@........@.......
......@.............
...@.....@......@...
.......@.......@....
.@..........@.@....@
..@..@..@..........@
............@.....@@
..................@@
18
6 3 0
9 10 0
14 0 0
16 18 0
17 7 0
4 0 0
6 12 1
13 17 1
6 1 1
3 11 1
4 8 1
0 5 1
8 15 2
19 2 2
7 11 2
0 1 2
8 12 2
1 18 2

3 18 0
12 8 0
17 5 0
17 19 0
18 9 0
3 17 0
11 19 1
3 8 1
17 14 1
2 15 1
3 11 1
14 15 1
2 12 2
2 18 2
8 16 2
0 12 2
4 15 2
1 19 2
