width 20
height 20
@...................
@...................
..@.@..@........@.@.
.........@..........
......@....@........
....................
......@..........@..
...@................
..........@...@.....
@.@.................
@.....@.............
........@...@....@..
...........@....@...
.@............@....@
....@...............
......@......@..@...
....@....@..@.......
..................@.
......@.............
....@...............
18
3 11 0
9 10 0
13 5 0
1 4 0
16 6 0
0 7 0
2 17 1
13 7 1
4 1 1
2 13 1
16 4 1
10 17 1
15 1 2
5 13 2
17 0 2
1 8 2
6 12 2
19 8 2

13 8 0
18 0 0
9 8 0
10 1 0
18 10 0
18 19 0
3 10 1
6 19 1
16 9 1
19 1 1
1 15 1
13 3 1
5 2 2
5 13 2
3 16 2
8 5 2
16 11 2
13 7 2
