width 20
height 20
@@..........@....@..
.@....@....@.....@..
...@.........@......
....................
.....@..............
................@...
.................@..
............@@.@....
............@@......
.......@..........@.
....................
....................
........@.@.....@...
.@..................
..@........@.@.....@
........@...........
.........@.@........
..@..@.@........@...
.......@............
........@..........@
18
2 19 0
3 10 0
6 11 0
3 14 0
13 17 0
8 10 0
16 1 1
0 15 1
13 4 1
16 3 1
7 2 1
11 8 1
8 18 2
18 13 2
19 15 2
5 3 2
3 15 2
18 4 2

2 8 0
4 17 0
19 0 0
16 0 0
1 3 0
15 19 0
3 7 1
12 15 1
14 0 1
12 6 1
6 10 1
0 17 1
8 4 2
19 10 2
10 3 2
4 3 2
18 17 2
11 3 2
