width 20
height 20
@@@@@@....@.........
@@@@@@.......@....@.
@@@@@.......@.......
@@@@@...@.........@.
@@@@@.............@.
@@@@@..@.....@......
@@@@@......@......@.
@@@@@@....@..@......
............@.......
.......@............
....................
@..@...@..@.........
.............@......
......@.............
...........@.@@...@.
....@...@.....@.....
......@...@......@..
.......@......@.@...
......@@............
....@@@@............
18
9 18 0
7 4 0
7 12 0
1 11 0
10 8 0
6 6 0
1 18 1
11 19 1
12 19 1
2 10 1
5 11 1
12 12 1
6 2 2
15 18 2
9 19 2
10 14 2
5 16 2
7 16 2

12 19 0
19 15 0
14 1 0
12 9 0
11 8 0
7 8 0
15 16 1
16 18 1
14 18 1
8 1 1
9 10 1
2 12 1
6 7 2
6 4 2
19 0 2
0 18 2
2 10 2
4 18 2
