width 20
height 20
.............@...@@@
..........@......@@@
.................@..
....................
...@....@@.@....@...
....@.......@.......
...@.........@..@...
@..........@........
...................@
.........@...@..@...
...@................
........@....@......
@...........@.......
...@.@..............
......@..@....@.....
..@.................
.........@.@........
......@...........@.
......@......@......
........@@..........
18
14 3 0
11 1 0
17 6 0
14 17 0
19 4 0
3 5 0
8 14 1
2 16 1
12 3 1
7 16 1
3 11 1
4 8 1
10 11 2
10 2 2
9 15 2
11 6 2
9 7 2
18 7 2

1 10 0
10 0 0
1 18 0
17 18 0
1 19 0
8 2 0
10 18 1
3 2 1
15 3 1
15 5 1
6 10 1
4 2 1
8 16 2
5 4 2
10 15 2
2 16 2
10 7 2
7 6 2
