width 20
height 20
....................
...................@
..@.@..............@
...................@
....@..@.@.@........
.............@......
.@.@.@......@..@....
................@...
............@.......
........@...........
.........@...@...@..
....................
....@@...........@..
....@@..............
....................
@.....@....@..@.....
@...................
..@.............@...
.....@..............
...@........@.......
18
13 11 0
1 13 0
13 0 0
9 12 0
9 15 0
14 12 0
5 19 1
12 4 1
3 0 1
15 9 1
14 3 1
11 9 1
8 19 2
12 14 2
8 14 2
10 15 2
12 18 2
19 8 2

0 0 0
5 0 0
2 1 0
10 11 0
17 2 0
5 5 0
2 9 1
1 16 1
1 4 1
0 5 1
7 9 1
10 6 1
14 1 2
6 1 2
17 11 2
1 7 2
12 18 2
15 16 2
