width 20
height 20
....................
....@...............
....................
...@..@.@....@......
@..............@.@..
@........@..........
....................
....@........@...@..
.........@.@........
.................@..
@.........@.@..@....
@@............@.....
............@.......
...@.......@....@...
.@..@...............
.........@..........
....................
.....@..@....@......
....................
..........@@...@@...
18
4 17 0
18 1 0
13 19 0
13 1 0
17 18 0
5 1 0
12 15 1
10 4 1
14 8 1
19 9 1
2 9 1
9 12 1
17 12 2
17 8 2
3 6 2
0 6 2
6 9 2
6 14 2

16 3 0
7 10 0
9 12 0
7 19 0
19 9 0
1 17 0
6 19 1
11 5 1
12 0 1
9 0 1
17 14 1
19 3 1
15 14 2
17 17 2
17 2 2
13 8 2
15 6 2
17 18 2
