width 20
height 20
..................@@
..@.....@...........
................@...
..@.......@.........
........@..@........
......@...@....@....
.@..................
....................
...........@........
@....@.....@@..@....
....@....@.@@.......
..@..........@......
......@.............
...@............@...
.....@..............
....@..........@..@.
........@...@@..@...
..@......@..........
...........@......@.
.......@@...........
18
3 15 0
19 17 0
3 0 0
19 8 0
10 16 0
14 1 0
15 7 1
15 16 1
15 10 1
8 14 1
11 3 1
14 0 1
9 7 2
0 3 2
3 4 2
15 18 2
1 10 2
2 7 2

17 3 0
2 6 0
2 4 0
14 0 0
8 3 0
8 10 0
19 2 1
0 0 1
1 4 1
10 17 1
7 15 1
11 3 1
14 19 2
2 0 2
15 8 2
1 5 2
4 16 2
15 18 2
