width 20
height 20
...................@
.@......@......@....
@...................
@...................
..@......@.........@
....@......@.@......
@...................
............@...@...
..@............@...@
.......@............
.....@..@...........
...........@.@......
.@...@...@..@.....@.
.................@..
........@...@.......
..@..........@......
.......@........@...
....................
.......@.........@@.
.@@..............@@@
18
3 10 0
15 9 0
8 19 0
6 3 0
14 6 0
16 4 0
3 0 1
4 3 1
11 16 1
16 8 1
17 5 1
2 12 1
1 16 2
16 18 2
1 2 2
10 4 2
11 19 2
0 14 2

7 3 0
0 15 0
5 16 0
6 9 0
2 13 0
10 13 0
13 12 1
14 11 1
5 13 1
12 4 1
5 15 1
7 7 1
4 11 2
1 0 2
2 2 2
14 16 2
1 9 2
14 2 2
