width 20
height 20
@..............@....
...@..............@.
....................
........@..@@.......
.....@.........@...@
...@..........@@...@
.....@..@.@..@@@@@@@
...........@..@@@@@.
..............@@....
.....@.........@....
....@..@.....@......
..@......@.........@
@.......@..@........
.@..@..@.....@......
....................
..@..@..............
........@...........
@...............@...
....................
@...................
18
0 18 0
3 10 0
13 17 0
18 9 0
14 9 0
12 15 0
2 0 1
14 13 1
10 9 1
11 6 1
15 10 1
10 17 1
4 2 2
18 5 2
3 17 2
12 2 2
6 2 2
17 5 2

1 18 0
19 0 0
1 0 0
10 12 0
6 12 0
11 9 0
3 3 1
7 6 1
3 14 1
9 6 1
16 0 1
19 9 1
12 16 2
3 11 2
0 15 2
4 12 2
1 8 2
5 7 2
