width 20
height 20
@@@@................
....................
....@.....@.......@.
.......@.@..........
.............@......
.@.@.............@..
.............@......
@..@.......@........
...@@.@..@..........
.............@@@....
.......@...........@
...........@........
............@.......
............@@......
.......@............
................@...
..............@.....
..................@.
..@..@..............
..............@@....
18
0 10 0
11 2 0
10 8 0
8 0 0
4 12 0
5 15 0
19 4 1
16 17 1
16 18 1
16 14 1
5 9 1
9 0 1
19 18 2
15 1 2
13 5 2
0 15 2
5 12 2
9 7 2

5 5 0
5 15 0
19 16 0
6 7 0
5 10 0
7 9 0
12 5 1
18 19 1
12 17 1
2 7 1
15 7 1
9 1 1
8 16 2
0 8 2
11 19 2
0 15 2
8 13 2
11 1 2
