width 20
height 20
@..............@@@@@
@.......@......@@@@@
.@...@..............
.......@.....@......
....................
...........@.....@..
...............@.@..
.....@.......@......
....@...@...........
.......@............
......@...@....@....
......@..@...@......
....................
........@.......@...
.@....@............@
....@..............@
..@.....@..@.@...@..
...........@........
...........@........
@.................@@
18
10 16 0
12 12 0
11 4 0
9 4 0
14 8 0
8 4 0
17 12 1
7 6 1
19 9 1
6 18 1
8 10 1
9 0 1
15 16 2
4 1 2
8 9 2
16 12 2
18 10 2
12 17 2

10 2 0
12 13 0
12 4 0
2 2 0
19 13 0
19 17 0
1 0 1
15 16 1
8 0 1
2 15 1
8 10 1
6 19 1
6 12 2
1 3 2
18 2 2
11 13 2
16 3 2
12 16 2
