width 20
height 20
@@@@......@@........
@@.........@........
@@..@..@..........@@
@@...........@....@@
......@...@......@.@
........@...........
...........@.@......
................@...
..@....@............
..............@.....
....................
..@..............@..
......@...@.........
.............@......
..@..............@..
..............@.....
...@............@...
........@.@.@.......
....................
@@.......@..........
18
4 11 0
7 15 0
10 8 0
19 9 0
2 17 0
9 16 0
5 9 1
17 8 1
6 8 1
19 6 1
18 18 1
7 9 1
11 8 2
6 16 2
6 6 2
16 19 2
15 10 2
6 5 2

16 14 0
15 10 0
13 9 0
5 4 0
17 1 0
0 10 0
3 8 1
15 0 1
17 13 1
10 9 1
17 12 1
18 15 1
1 16 2
17 18 2
6 8 2
1 5 2
7 11 2
6 5 2
