width 20
height 20
..........@......@..
....................
...........@........
....@...@...........
...........@..@.....
....................
....................
..........@.@...@...
.@.@.@..@...@.......
............@@......
.@........@.........
@@...@..............
@........@..........
..................@.
.........@.....@....
....................
...@..@..@..........
.................@..
....................
....................
18
7 16 0
18 9 0
9 11 0
5 5 0
13 1 0
12 17 0
5 10 1
1 18 1
2 15 1
7 1 1
10 14 1
17 12 1
3 10 2
0 19 2
7 18 2
13 3 2
14 7 2
18 18 2

10 11 0
12 0 0
9 8 0
5 7 0
3 10 0
8 9 0
11 18 1
18 1 1
10 5 1
2 18 1
3 18 1
2 3 1
4 10 2
7 4 2
18 3 2
6 3 2
0 15 2
18 15 2
