width 20
height 20
.............@......
....................
.....@....@.........
..@.............@...
...............@....
......@............@
....@..@.......@...@
...@........@....@..
....................
..@.@...@...........
......@.............
....@.........@.....
...@..@.............
.......@@@..........
.................@..
..@.........@......@
....@...........@...
....................
..........@....@....
..........@.........
18
14 13 0
19 2 0
12 0 0
1 5 0
5 3 0
5 14 0
1 6 1
9 18 1
2 0 1
12 17 1
6 15 1
18 16 1
13 18 2
0 14 2
16 5 2
0 18 2
5 6 2
4 5 2

5 18 0
0 9 0
11 1 0
9 15 0
9 3 0
5 14 0
0 1 1
14 13 1
4 1 1
10 3 1
2 1 1
12 12 1
1 4 2
10 6 2
9 2 2
12 5 2
12 8 2
5 5 2
