width 20
height 20
.........@@@@@@.....
.....@....@@@.......
...@..@..........@..
...............@....
....................
....@...@....@......
...@.....@..........
..............@.....
.......@...@.....@..
........@...@...@...
.@..@..@............
........@...........
....................
...........@....@...
....@....@..........
..@.........@.......
@@..................
@@@...@.@..@..@.....
@@@...@.............
@@@@@...@...........
18
15 2 0
9 16 0
5 14 0
18 1 0
15 15 0
12 2 0
17 1 1
13 10 1
9 5 1
18 5 1
16 16 1
7 7 1
18 6 2
18 9 2
0 10 2
19 17 2
8 16 2
14 15 2

15 2 0
11 14 0
9 9 0
3 9 0
1 6 0
8 18 0
9 11 1
0 0 1
6 16 1
15 7 1
3 1 1
15 8 1
10 9 2
17 11 2
0 3 2
18 14 2
13 16 2
5 3 2
