width 20
height 20
.........@..@.......
.@....@..........@..
...........@....@...
..........@.......@.
...............@....
....................
..@........@...@....
...@................
.........@..........
..@.@.@........@....
...................@
@@...........@......
........@...@.......
...........@...@....
.......@....@.......
........@..@....@...
....................
....................
....@.....@.@..@....
....................
18
8 17 0
6 3 0
18 19 0
14 8 0
7 7 0
12 3 0
17 17 1
19 18 1
12 2 1
18 1 1
14 18 1
5 0 1
13 12 2
18 17 2
1 9 2
9 11 2
16 19 2
19 6 2

3 14 0
15 19 0
1 0 0
19 14 0
19 17 0
18 0 0
18 9 1
14 12 1
19 0 1
17 7 1
3 0 1
5 1 1
10 2 2
2 4 2
4 11 2
8 11 2
6 0 2
14 13 2
