width 20
height 20
.....@..............
.............@......
..................@.
.......@....@.......
.@.@.@...@..........
..........@....@....
....................
..........@.@.......
....@...............
.@.................@
@@@.@...@....@.....@
@@@@............@...
@@@....@............
..............@.@...
.....@....@.@.......
................@...
.........@....@.....
...........@........
....................
....................
18
2 8 0
2 13 0
2 4 0
7 7 0
14 14 0
2 18 0
9 11 1
15 19 1
1 17 1
10 15 1
14 1 1
16 12 1
1 6 2
0 19 2
6 5 2
6 2 2
16 4 2
12 19 2

11 10 0
7 13 0
12 17 0
19 19 0
0 0 0
15 17 0
6 11 1
19 1 1
11 1 1
1 6 1
10 0 1
17 17 1
11 6 2
4 3 2
8 5 2
12 10 2
4 11 2
12 11 2
