width 20
height 20
....................
.@.@...........@....
....................
......@.....@.......
@@.......@...@..@...
.......@............
....................
........@.....@.@...
.@......@...........
..........@.......@.
......@........@....
....@.........@.....
@@@....@............
@@..@.......@.@.....
.@....@.........@@..
............@.......
.@..................
.......@.@......@...
..@.........@.......
..................@.
18
12 7 0
15 17 0
4 12 0
15 16 0
16 6 0
19 12 0
16 19 1
4 1 1
8 12 1
19 1 1
0 18 1
8 2 1
13 8 2
18 6 2
19 6 2
17 18 2
16 1 2
2 4 2

8 2 0
4 0 0
17 0 0
5 7 0
5 17 0
14 18 0
14 12 1
4 7 1
8 10 1
15 2 1
18 5 1
16 0 1
15 8 2
17 1 2
15 15 2
18 15 2
0 8 2
14 0 2
