width 20
height 20
@..@........@.......
...........@........
......@...........@.
....@.......@.......
.@....@.@..@...@.@..
....................
......@...@.........
....@.........@.....
.......@............
.....@........@..@..
.....@..............
..@..@...@..@..@....
...................@
...@.@..............
.......@..@.........
..........@.....@@..
.......@..@@........
@...................
........@...........
...@...............@
18
1 18 0
5 18 0
13 18 0
1 7 0
4 13 0
7 15 0
18 12 1
19 9 1
16 8 1
5 7 1
8 1 1
8 10 1
17 2 2
0 9 2
19 4 2
18 4 2
5 19 2
6 3 2

16 4 0
7 13 0
2 3 0
6 0 0
9 19 0
8 3 0
13 3 1
2 2 1
0 11 1
11 8 1
6 8 1
9 8 1
9 12 2
6 9 2
13 19 2
4 13 2
10 0 2
14 19 2
