width 20
height 20
....................
.....@..@.@.........
.................@..
.@.................@
............@......@
....@.....@.........
.............@......
.......@...........@
...@............@...
@...................
....@...@.@.........
.........@.@...@....
....................
....@@......@...@...
....@@.@..........@.
.................@..
...@.......@.@......
.....@..........@..@
........@...........
@@.................@
18
5 4 0
18 13 0
9 7 0
6 0 0
17 7 0
13 4 0
4 4 1
5 15 1
2 1 1
4 17 1
6 18 1
6 2 1
19 6 2
3 6 2
3 0 2
13 15 2
12 6 2
8 13 2

18 13 0
10 14 0
3 7 0
12 7 0
16 7 0
15 6 0
6 11 1
16 3 1
3 2 1
4 18 1
6 17 1
17 16 1
18 12 2
15 19 2
10 19 2
14 7 2
19 11 2
7 13 2
