width 20
height 20
.............@@.....
.........@.......@..
.............@......
...........@........
@...................
@....@....@.....@...
@..............@....
.......@@...........
.......@..@...@.....
....................
............@.@.....
.........@......@...
.....@..@...........
....@........@......
..................@.
..@......@.@........
.....@......@.@.....
.@..................
....................
.................@@@
18
13 8 0
2 2 0
15 18 0
14 3 0
8 6 0
3 18 0
4 5 1
12 8 1
12 1 1
4 0 1
18 11 1
14 13 1
19 6 2
0 15 2
12 14 2
18 6 2
1 13 2
1 7 2

5 3 0
2 7 0
2 12 0
18 11 0
17 2 0
19 12 0
6 12 1
15 9 1
8 1 1
2 11 1
14 18 1
3 3 1
15 12 2
19 18 2
0 0 2
0 9 2
16 1 2
6 11 2
