width 20
height 20
........@...........
..@.....@.@.........
....................
@.....@..@..........
........@......@....
............@.......
...@...@........@...
..@......@........@.
.@..........@.......
....................
@.......@...@.@.....
....................
..............@.....
......@............@
........@....@.@.@.@
..@..@.....@........
...@................
....................
....................
@....@..............
18
14 11 0
14 2 0
3 1 0
8 12 0
18 10 0
5 2 0
15 16 1
1 15 1
18 0 1
0 0 1
3 9 1
15 6 1
14 9 2
0 8 2
11 12 2
16 4 2
7 13 2
15 7 2

15 5 0
12 14 0
11 11 0
8 12 0
10 7 0
16 14 0
16 4 1
12 15 1
17 12 1
10 4 1
9 9 1
13 12 1
1 14 2
1 7 2
0 1 2
6 5 2
17 2 2
16 5 2
