width 20
height 20
..@.@@@@@@@....@..@.
.@@.@@@@@@@@@.@.@...
......@@@@@.@.....@@
.@@.@.@@@@...@.@.@@@
...@@@@@.@@@....@@@@
.@@.@.@@.@.@.@@.@@@.
..............@.....
.@@.@.@@.@.@@..@@.@.
...@@.@@..@...@@@@@.
@@@.@..@@@..@.@.@...
@.....@.@.@..@....@@
@@@.@......@@.@@.@@.
.....@.@@.@.@.@..@..
@.@@.@.@.......@.@@.
.@....@@@.@.@.@.@.@.
..@.@.@@..@@@.......
.@@@.@...@..@@@@.@@.
..@....@..@........@
@.@.@.@..@@@.@.@.@..
.....@@@.@@@@@@@@@@@
11
18 18 0
17 0 0
12 10 0
9 15 0
5 11 1
5 15 1
1 8 1
17 9 1
8 15 2
19 11 2
11 8 2

12 6 0
1 15 0
13 8 0
7 10 0
10 6 1
5 15 1
0 6 1
6 11 1
8 15 2
9 14 2
10 16 2
