width 20
height 20
@@@@@....@...@..@.@.
@@@@@.@.@.@@.@.@....
@@@@@@..@........@.@
@.@@@@@.@.@.@.@.@...
...@@@..@@...@.@@@.@
@.@@@..@@.@.@..@@@..
...@.@.@......@@@..@
@.@..@..@.@.@@.@.@..
....@.@...@.......@@
.@@.....@.@.@.@@.@@@
.@.@.@@.@@@@@.@..@@@
....@@@@..@@@@@@..@@
.@.@@@@..@@@@@@..@.@
@...@.@.@.@@@@@@....
..@@.......@@@@@.@.@
@...@@.@.@..@@@.@...
@.@..@.@..@..@...@.@
...@.@@.@@@.@.@.@@@.
@.@.@.@.@.@.........
............@.@.@.@.
11
15 15 0
1 18 0
5 0 0
17 0 0
10 2 1
17 6 1
16 18 1
1 8 1
7 10 2
9 2 2
11 15 2

3 19 0
1 19 0
19 7 0
3 15 0
1 3 1
10 4 1
14 8 1
12 18 1
1 14 2
2 13 2
15 3 2
