width 20
height 20
@.......@@@@@@@@@@@@
@.@.@@.@@@@@@@.@@@@@
@@@@...@@@@@.@...@@@
@@@.@.@.@@@@.@.@@.@.
@@.......@......@...
@@@.@.@.@..@.@.@@@@.
@@@@@@...@..@@......
@@@.@.@.@@@.@..@.@@.
@@@......@@@@.@@@...
@@..@.@.@@@@@..@..@.
@@@.@@...@@@@.@.@..@
.@...@.@@.@.@.@.@.@@
..@.@.@.@........@@@
.@..@.....@.@@@.@.@@
..@.@.@.@..@@@......
.@.....@@@@.@.@.@.@.
...@.@@.@.@....@...@
.@..@.@.....@.@.@.@@
@..@....@@.@.......@
@.@@@.@...@@@.@.@.@@
11
12 4 0
7 3 0
11 13 0
9 12 0
17 15 1
13 15 1
5 14 1
15 17 1
5 3 2
17 10 2
0 17 2

12 2 0
14 4 0
11 13 0
5 5 0
8 4 1
5 15 1
7 9 1
17 18 1
5 13 2
3 1 2
7 7 2
