width 20
height 20
@@..@@.@.@@@@.@@....
@.@.@.....@@..@..@.@
....@@.@.@.@.@.@..@@
@.@@.@@..........@@@
.......@.@@.@@.@..@@
.@.@.@..@..@@@@..@@.
.@@...@@.@..@..@....
@.@.@..@..@.@@...@.@
...@@@.@.@.....@@@@@
@.@.@.....@.@.@@@@@@
..@...@.@....@@@@@@@
@...@..@@@@.@@@@@@@@
@@@..@.@@@.@@@@@@@@@
@...@.@@@@.@@@@@@@@@
..@.....@....@@@@@@@
@..@.@.@@@.@.@@@@@@@
@.@...@@@..@@@@@@@@@
..@@.@.@.@.@@@@@@@@@
.@..........@@@@@@@@
@@@@@.@@.@.@@@@@@@@@
11
4 16 0
15 7 0
1 2 0
14 4 0
11 3 1
18 7 1
3 10 1
16 2 1
4 6 2
6 17 2
10 2 2

7 5 0
12 14 0
6 4 0
0 6 0
12 8 1
3 11 1
16 2 1
9 5 1
0 5 2
5 14 2
10 12 2
