width 20
height 20
@@.@@....@..@..@....
@.....@.@..@..@..@@.
.@.@.@....@.@..@..@@
.@.@@.@.@.....@@.@.@
..@.@.@@@.@@.@@....@
.@.....@.@@@.@.@.@..
...@@.@..@.@......@@
@@.@.@.@.@...@.@@...
...........@.@@@@.@.
.@@.@.@.@.@@@.@@.@..
...@.@@@@@@.......@.
@.@..@@.@@@@@.@@@.@.
@...@...@@@@.....@..
@@.@.@@.@.@.@.@@@@@@
@@..................
@@.@@.@.@.@.@.@.@.@.
@.@@.@.@.@.@.@@..@..
................@.@.
.@.@.@@.@.@.@.@...@.
@..@...@...@...@.@..
11
7 17 0
13 14 0
17 2 0
16 4 0
16 5 1
17 11 1
16 10 1
12 5 1
12 4 2
13 9 2
17 14 2

16 4 0
5 0 0
11 13 0
17 4 0
7 14 1
13 14 1
1 1 1
2 18 1
3 12 2
5 14 2
1 8 2
