width 20
height 20
@..@@...............
.@....@.@.@@.@.@.@.@
.@@.@..@.@@@..@@@...
....@@....@@.@...@.@
@.@...@.@@..@.@@....
...@.@@@@.@......@.@
@.@...@.....@.@.@@..
..@.@@..@.@.@@..@.@.
.@..@.@.@@.@.@.@....
.@.@....@....@..@.@.
@.@.@.@..@.@.@@@@@@.
......@.@...@.@.@.@.
@.@@.@...@@........@
@...@@@.@..@.@@.@.@@
..@@.@.@..@@@@@@...@
@.@......@@@...@@.@.
...@@.@@@.@.@.@.@...
@.@...@.@.........@@
....@.....@.@.@.@...
@.@..@@.@@...@...@.@
11
4 11 0
0 3 0
10 0 0
4 12 0
10 11 1
7 6 1
0 2 1
9 14 1
17 11 2
1 15 2
10 9 2

19 8 0
18 4 0
13 0 0
6 9 0
12 12 1
5 17 1
10 10 1
17 12 1
7 10 2
0 9 2
16 14 2
