width 20
height 20
....@.@.@.@@@@@..@..
.@.@.......@@@@@...@
.@...@@@@.@.@.@.@@.@
..@.@...............
.@.@@@@.@.@@@.@@.@@@
...@@@@@@@@@@@@@@@@@
.@.@@.@.@.@.@@@@@@@@
@............@@@@@@@
.@.@.@.@.@@.@@@@@@@@
....@@@@@...@@@@@@@@
.@.@.@.@..@..@@@@@@@
..@....@@.@.@@@@@@@@
.@.@.@.@@@@@@@@@@@..
...@.@..@@.@@@.@@.@.
.@...@@.....@.......
@..@.@@.@@@@.@.@.@.@
.@.@@@@.@@......@@..
.@....@..@.@.@.@...@
...@.@.@....@..@@.@@
@.@.....@.@.@.@@@.@@
11
18 14 0
19 3 0
6 10 0
0 11 0
11 14 1
2 17 1
1 18 1
13 19 1
6 1 2
0 4 2
9 11 2

0 2 0
3 14 0
2 17 0
4 17 0
2 13 1
6 13 1
18 15 1
14 15 1
1 7 2
14 18 2
1 3 2
