width 20
height 20
...@@.@@...@.@@.@..@
@@.....@.@........@@
@@@@.@.@.@@.@@.@@.@@
@@@@@...@@....@@.@@@
@@@@.@.@..@.@....@@@
.@@@.....@@@@.@.@.@@
..@..@@.@.@..@......
@..@..@...@@..@.@.@@
.@...@.@@@.@@.@.@@@@
...@@.............@@
.@@..@.@.@.@@.@.@..@
....@...@.@....@..@.
@.@.@@.@...@@.@@@.@.
.@@.....@.@.@.@@@@..
.@.@.@.@.....@@@.@.@
......@..@.@..@@...@
@.@.@..@..@@.@.@.@..
...@@@@@.@@.......@@
@.@.@.@.@.@@.@.@.@@@
..............@..@@@
11
7 13 0
6 13 0
13 19 0
13 9 0
11 14 1
8 16 1
3 19 1
17 5 1
5 1 2
18 10 2
16 19 2

10 14 0
6 4 0
18 15 0
1 9 0
11 2 1
0 19 1
19 6 1
5 16 1
12 9 2
1 11 2
15 19 2
