width 20
height 20
@@@@@@@@@@@@@@@@@@@@
@@@@@@@@@@@@@@@@@@@@
@@@@@@@@@@@@@@@@@@@@
@@@@@@@@@@@@@@@@@@@@
@@@@@@@@@@@@@@@@@@@@
@@@@@@@@@@.@@@@@@@@@
@@@@@@@@@...@@@@@@@@
@@@@@@@@.@.@.@@@@@@@
@@@@@.@.......@.@@@@
@@.@...@.@.@@...@@@@
.....@....@.@.@@.@.@
@@.@.@@@.@..........
.@..@@.@..@.@.@.@@.@
...@.....@@@@@@@@@@@
.@.@@@.@@.@.@.@.@@@@
@...@...........@@@@
@.@@.@.@.@@.@@@..@@@
.@......@@.@.@@.@@@@
...@@@.@@........@.@
.@..@..@@@.@@@.@....
11
7 15 0
11 16 0
13 14 0
0 19 0
2 13 1
15 18 1
12 18 1
6 10 1
0 17 2
6 9 2
9 14 2

2 9 0
6 18 0
8 16 0
5 17 0
15 9 1
8 8 1
6 17 1
13 14 1
16 10 2
4 10 2
13 11 2
