width 20
height 20
....@.@.@.@@.@.@@..@
@.@...............@.
...@.@.@.@.@.@@.@...
@.@.@@@@..@..@@@..@.
.....@...@@@.@@.@@..
@@@.@@@@@@@.@....@@.
..@.@.@.@....@@.@.@@
@.........@.@.@.....
..@@.@.@@..@....@.@.
.@.@..@@..@@@.@@...@
@....@@.@..@@@..@.@@
.@.@.@..@.@.@..@@..@
...@@@@......@.@..@@
.@.@..@@.@.@.....@.@
..@.@..@..@..@.@....
@.....@.@@.@..@.@.@@
.@.@.@...@.@.@....@.
...@..@@...@@@@.@.@.
.@..@@...@@.@@@.@...
..@..@@@.........@.@
11
0 8 0
2 13 0
5 1 0
0 16 0
11 5 1
15 16 1
17 16 1
17 2 1
11 14 2
2 2 2
2 4 2

19 14 0
8 16 0
11 18 0
0 16 0
8 17 1
18 0 1
15 15 1
8 18 1
2 7 2
6 14 2
4 9 2
