width 20
height 20
@@@@@@@......@@.@.@.
@@@@@@..@@.@@.@...@.
@@@@@@@.@.@.@...@@..
@@@@@@@.......@....@
@@@@@...@.@.@..@.@.@
@@@@@.@..@.@.@@@@..@
@@.@..@@.....@.@.@.@
@@..@...@.@.@.......
@@.@.@.@..@..@.@.@.@
@.....@@@..@@..@@...
@@.@.@.@..@@@@..@@.@
@@..@...@@@@@@.@.@.@
@@.@.@.@.@@@@@...@..
@....@.........@.@.@
..@@...@.@@@@.@...@@
@...@@.@@@.@.@.@.@.@
@@.@@.@.@...........
@@@@....@.@.@@.@.@.@
@@@.@.@...@@....@..@
@@@...@@.@@@.@.@@@..
11
13 7 0
15 16 0
9 0 0
14 7 0
9 17 1
13 16 1
2 7 1
18 3 1
7 5 2
1 15 2
16 1 2

6 13 0
16 16 0
4 10 0
10 5 0
18 12 1
13 13 1
10 13 1
9 2 1
9 13 2
8 10 2
1 15 2
