width 20
height 20
@@....@@...@@@@@@@@@
@@.@.@..@.@.@@@@@@@@
@...@.@......@.@@@@@
.@.@....@.@.@.....@@
.....@.@@@..@.@.@.@@
.@@.@.@.@.@....@.@@@
..@@@.@.@...@.@..@@@
.@........@..@.@.@@@
.@@.@@.@.@.@......@@
...@@@@@@..@.@@.@...
@.@..@@@@@.....@.@.@
....@.@@@@@@.@....@@
@.@@...@@.@@.@.@@..@
.....@......@.@...@@
.@.@.@@@@.@@..@.@...
..@@@.@.@..@.@...@.@
.@@@......@@.@@.@@@@
..@.@.@@.@.......@@@
.@......@.@.@@@.@.@.
..@@@.@@......@.....
11
1 10 0
9 5 0
18 15 0
1 6 0
3 0 1
8 0 1
4 18 1
2 1 1
14 15 2
3 18 2
4 16 2

16 13 0
13 3 0
13 14 0
14 15 0
12 17 1
2 14 1
14 5 1
16 19 1
3 10 2
15 14 2
8 13 2
