width 20
height 20
@@@..@@@@@.@@@.@..@@
@@..@@@@@@..@...@..@
@.@.@@@@@..@.@.@..@.
.....@@@..@.....@...
@.@.@.@@@...@.@...@.
@.@....@..@..@@@.@@.
@@..@.@@@..@..@.@.@.
@.@..@@...@@@@......
....@@@@@.@@@..@.@.@
@.@...@@@@.@.@.@..@@
@@@@@...........@@@@
@@@...@.@.@@.@.@.@.@
.@.@.@.@@@..@.......
.@.@.@..@@@..@@@@@.@
.......@....@..@....
@.@@.@.@@.@..@..@@@.
@@@.@..@.@.@...@....
.@@.@@......@.@.@@@.
.......@.@.@........
.@.@@.@..@@..@@@.@.@
11
9 2 0
8 7 0
14 1 0
10 10 0
11 10 1
12 3 1
0 8 1
2 18 1
7 11 2
11 5 2
6 14 2

4 11 0
13 17 0
14 10 0
19 6 0
14 2 1
1 18 1
4 15 1
6 17 1
16 18 2
12 5 2
19 5 2
