width 20
height 20
..@@@@@.@@@.@.@@....
@.@..@...@@....@@@@.
....@..@....@.@.....
@.@...@..@.@@.@.@.@.
...@.@@@..@..@...@..
@.@@@@@@.@.@.@@@@.@.
...@.@..@...........
@@.....@@@.@@@@.@@.@
@@@@.@......@@@@.@@.
@...@..@.@.@.@.@....
..@...@@@..@...@.@@@
@..@.@.@@@@@@@...@..
..@@@..@@@@.@.@@..@.
@..@@@.@@@@......@..
@@..@...@@..@.@.@@@.
@@.@.@@...@..@......
@@...@..@...@@@.@.@.
@@.@..@..@.@@@@@...@
@@@.@...@..@@@@@@.@@
@@@...@.@.@@@@@@@@@@
11
2 9 0
10 8 0
13 12 0
8 4 0
10 3 1
9 16 1
7 19 1
0 12 1
17 15 2
17 0 2
0 10 2

19 11 0
11 14 0
7 3 0
2 9 0
5 17 1
6 2 1
15 14 1
1 10 1
2 6 2
5 19 2
5 7 2
