width 20
height 20
..@.@..@@@....@.@@@@
.@....@.@.@.@....@..
..@.@........@.@@.@.
.@@@.@@@.@@.@.......
..........@.@.@.@.@.
@@.@.@.@.@.@.@@..@..
@@..@@@.@@...@.@@.@.
@@@..@@....@....@...
@@@@@...@@@@.@.@..@.
@@@@@@.@....@....@.@
@@@@@@...@.@@@.@.@..
@@@@@@.@..@...@@.@.@
@@@@@@@..@.@.@.@@...
@@@@@@@@.........@.@
@@@@@@@.@.@@.@.@....
@@@@@@......@@@..@@.
@@@@@@@.@.@.@..@.@.@
@@@@@@@@@..@..@@.@..
@@.@@@@@.@@.@......@
@.............@.@@..
11
11 0 0
18 9 0
9 19 0
19 5 0
0 3 1
16 18 1
7 10 1
9 1 1
0 1 2
5 19 2
8 15 2

15 9 0
10 6 0
9 4 0
8 3 0
5 1 1
12 6 1
9 13 1
12 0 1
2 1 2
16 13 2
0 4 2
