width 20
height 20
......@@.@.@...@@@@@
.@.@.@@..@..@.@.@.@@
..@....@.@.@........
.@.@.@@@.....@@@@.@.
....@@@..@.@.@...@..
@@.@.@.@..@@@.@.@@@.
@@.......@@@@.......
@.@@.@.@..@@@.@@.@.@
......@@@@@@@...@@@@
.@.@.@@@.@@...@@@@@@
..@..@@....@@...@@@@
.@.@...@.@@@..@@@.@@
@@...@.....@@.......
@..@@..@.@@...@.@.@.
@@...@@..@@@.@.@@@..
@..@@.@.@.@@.@..@@@.
@@.@........@..@.@..
@@@@@.@.@.@..@.....@
@@@@@@@@@..@@.@@.@..
@@@@@@@@@@....@...@@
11
13 8 0
8 2 0
8 11 0
13 0 0
13 6 1
12 14 1
2 11 1
10 16 1
14 4 2
10 18 2
4 2 2

11 19 0
17 13 0
10 10 0
10 3 0
9 15 1
7 15 1
13 0 1
10 1 1
3 12 2
8 1 2
15 5 2
