width 20
height 20
@.@.@@@.@@@@@@..@.@.
.....@...@@@@@@.....
@.@.@.@.@.@.@...@.@@
@..@..........@@....
..@.@.@.@.@@.@..@.@@
@......@.@@.@@@.@.@@
..@@.@@.........@@.@
@..@...@.@.@.@@.....
..@.@@@@.@@..@..@.@.
@..........@@@@.@@..
@.@@.@.@.@..@@@@@.@.
@..@.@@@@..@.@@@..@.
@.@@@@.@.@...@@@@...
..@........@@.@@..@.
.@.@@.@.@@.....@.@..
@@....@.@..@.@.@@.@.
...@.@...@@...@.@.@@
.@..@@@.@...@.......
@@@..@@@..@..@.@@.@.
....@@@@@..@@@@...@@
11
1 19 0
0 6 0
5 13 0
16 7 0
17 16 1
7 4 1
4 15 1
5 5 1
0 14 2
7 13 2
12 8 2

8 16 0
9 17 0
19 17 0
4 5 0
1 1 1
2 15 1
14 2 1
16 7 1
0 13 2
4 10 2
3 19 2
