width 20
height 20
......@........@@@..
.@.@.@.@@.@.@.@.@@.@
..@....@.@.@.....@..
@@.@.@.......@.@.@.@
@@...@@.@.@@@@@..@..
@@.@@@.@.@@.@.@@..@.
..............@.@@@.
.@.@.@.@.@.@@.....@.
..@@@@@.@@@...@.@@..
.@.@.@..@@@@.@.@.@@.
...@.@.@..@.........
.@.......@@@.@@.@.@@
..@.@@.@@@.@...@....
.@.@....@...@@@.@.@@
...@.@.@.@.@.@......
@.@.@.@........@@.@.
....@..@.@@.@.@...@.
.@@@.@....@@@@..@@..
..@....@@.@...@..@@.
@..@.@..@@@@@...@@@@
11
11 3 0
4 1 0
1 2 0
2 16 0
1 8 1
10 15 1
18 3 1
5 13 1
5 2 2
6 1 2
5 6 2

2 14 0
7 4 0
19 12 0
6 11 0
4 18 1
15 8 1
3 4 1
8 11 1
12 2 2
9 15 2
14 3 2
