width 20
height 20
@@@@@@@@@@@..@.@@@@@
@@@@@@@@@@.@....@@@.
@@@@@@@@@..@.@.@@@..
@@@@@@@@.@....@@@.@.
@@@@@@@....@@.......
@@@@@@@@.@.@@@@@.@@@
@@@@@@@..@@.@@@@@@@@
@@@@@@@@.....@...@@@
@@@@@@@@@.@.@@.@@@@@
@@@@@@@@@@.......@@@
@@@@@@@@@@@.@.@.@@@@
@@@@@@@@@@@..@..@@@@
@@@@@@@@@@@@..@....@
@@@@@@@@@@@@@@..@.@@
@@@@@@@@@@@@@@@@..@@
@@@@@@@@@@@@@@@@@.@@
@@@@@@@@@@@@@@@@@@@@
@@@@@@@@@@@@@@@@@@@@
@@@@@@@@@@@@@@@@@@@@
@@@@@@@@@@@@@@@@@@@@
11
17 15 0
17 14 0
14 2 0
13 4 0
9 8 1
17 12 1
11 6 1
19 3 1
14 13 2
8 5 2
15 11 2

9 2 0
10 5 0
15 7 0
12 9 0
13 12 1
7 6 1
14 13 1
13 3 1
9 7 2
16 5 2
10 1 2
