width 20
height 20
@@@..@..........@...
@.@.@.@@.@@.@.@@.@.@
...........@@@......
@.@.@.@@.@@.@.@.@.@.
.@.@@@...........@@@
....@..@@.@.@@.@..@@
@.@..@@..@.@@@@.@...
...@.@..@@..@@@...@@
@.@.@.@.@.@..@.@.@@.
............@@......
@.@@.@@.@.@.@.@.@@.@
....@@@@...@......@@
@.@..@@.@.@.@.@.@@.@
@@..@@.........@.@.@
@@@@@@.@.@.@@.@@....
@@@@@@@...@..@...@.@
@@@@@@@@.@.@..@@..@@
@@@@@@@@.@.@.@.@.@@@
@@@@@@@@..........@@
@@@@@@@..@.@@@.@.@@@
11
4 6 0
13 11 0
11 5 0
11 7 0
10 6 1
17 7 1
2 2 1
4 2 1
16 5 2
15 3 2
10 14 2

17 14 0
11 15 0
17 16 0
6 14 0
16 4 1
1 7 1
3 0 1
10 7 1
17 5 2
14 18 2
8 17 2
