width 20
height 20
@..@...@....@.@..@@.
..@.@.@.@.@@@.@.@.@.
@...................
..@.@.@.@.@@.@.@.@@@
.@@..@@@...@@@@..@@@
...@@@@@@.@@@@.@..@@
.@@..@@@@@.@.....@.@
....@..@@....@.@@@..
@.@.@@.@.@.@..@.@..@
@@..@..@...@.@....@@
@.@.@@...@@....@.@@@
.....@.@@@@@.@.@@.@@
@@@.@.@.@@@@@@......
..........@@...@@.@.
@.@.@.@.@..@@@.@.@..
..@..@@@..@@@@@....@
@.@.@@@@@.@@@@.@.@..
...@.@@@.@.......@.@
.@........@@.@.@@@..
..@@@.@.@.@@.@@@@..@
11
1 3 0
1 14 0
6 18 0
5 1 0
14 7 1
9 14 1
7 2 1
14 14 1
4 13 2
2 0 2
10 0 2

16 2 0
15 4 0
1 0 0
10 8 0
2 5 1
5 19 1
7 3 1
19 2 1
14 6 2
14 2 2
0 3 2
