width 20
height 20
@@@@@.@.@.@@@@@@@@@@
@@@@@......@@@@@@@@@
@@@...@.@.@@@@@@@@@@
@...@.@..@@@@@@@@@@@
.@.@@@.@@@@@@@@@@@@@
.@......@@@@@@@@@@@@
...@.@.@.@@@@@@@@@@@
.@..@@...@@@@@@@@@@@
..@@@@@@.@@@@@@@@@@@
@..@@@@..@@@@@@@@@@@
..@.@@.@..@.@@@@@@@@
.@.......@...@@@@@@@
@@@.@@@.@@@.@@@@@@@@
@@.@@@..@@...@@@@@@@
....@.@..@@.@@@@@@@@
@.@.....@....@@@@@@@
..@@.@@.@.@.@@@@@@@@
@...@@@@@.@@@@@@@@@@
..@@.@@.....@@@@@@@@
@.......@.@...@@@@@@
11
8 9 0
3 3 0
9 0 0
7 1 0
2 11 1
0 18 1
5 11 1
7 19 1
5 19 2
11 10 2
4 15 2

9 2 0
7 11 0
5 15 0
3 3 0
3 10 1
11 15 1
4 2 1
11 14 1
9 16 2
8 3 2
6 6 2
