width 20
height 20
@...................
@.@@.@@@@.@.@.@.@.@.
..@.@@@@@..@...@..@@
@...@@@@@@@@@.@.@..@
@@@..@...........@.@
@...@@@.@.@@@.@@.@..
.@.@.@.@.@.@.@....@.
.............@.@.@..
@.@@.@.@.@.@..@@@@@.
@@@@@@@.@..@.@.@....
@@@@@@@.@@.@...@@.@@
@@@@@@@...@..@..@@..
@@@@@@..@@.@@..@@.@.
@@@@@.@.....@@.@..@.
@@@.....@.@.....@...
@@@@.@.@..@.@.@.@.@.
@@@@@@@.@@.@..@@...@
@@@@@@@......@.@@.@@
@@@@@@@@.@.@.......@
@@@@@@@@..@..@.@.@@@
11
6 7 0
11 4 0
13 3 0
15 0 0
16 5 1
10 10 1
7 16 1
8 18 1
3 7 2
4 6 2
9 14 2

12 2 0
10 12 0
10 7 0
16 16 0
18 9 1
11 1 1
19 9 1
18 14 1
10 9 2
13 14 2
14 18 2
