width 20
height 20
@@@@@@@@@@@@@@@@@@@@
@@@@@@@@@@@@@@@@@@@@
@@@@@@@@@@@@@@@@@.@@
@@@@@@@@@@@@.@@....@
@@@@@@@@@@@@.@.@@@..
@@@@@@@@@@@....@.@.@
@@@@@@@@@@.@.@.@....
..@@@@@@@...@....@.@
@..@@@@@@@.@.@.@@.@.
..@@@@@.............
@..@....@.@.@.@.@.@.
..@.@.@..@@@.@.@.@..
@......@.@.@.....@@.
.@.@@.@..@.@.@@@....
..@.@..@@@...@..@.@.
@...@@@.@.@.@..@@@@.
..@.........@.@.@...
@..@.@.@.@@@..@...@.
..@@@@@...@.@.@.@..@
@..@@@@@@@.......@..
11
19 9 0
16 12 0
19 19 0
8 9 0
19 8 1
7 18 1
1 7 1
10 14 1
10 19 2
9 15 2
13 18 2

6 10 0
18 9 0
12 19 0
5 12 0
6 12 1
6 17 1
12 12 1
11 15 1
0 11 2
17 2 2
14 4 2
