width 20
height 20
.@.@...@@@.@........
....@.@@@....@.@@@.@
@.@....@@@.@..@.....
@.@@@.@.@...@@@.@.@@
.@........@.@.@.@.@.
..@@.@.@.@.@...@....
.@..@@@....@@.@@.@.@
..@..@.@@.@@@...@..@
@..@......@@@.@@.@..
@.@.@@.@.@.@.......@
@...@...@...@.@.@@..
..@@@@.@..@@...@@@.@
@...@@.@@.@.@.@..@..
@@.@..@.@...@.@.@@@.
@...@...@.@..@..@...
.@@...@...@.@@@..@@.
.@.@@.@.@@..@@..@.@.
.....@.@@.@.@.@.....
@@.@............@.@.
...@.@@.@.@.@.@@@@..
11
5 15 0
17 7 0
7 6 0
0 17 0
9 4 1
9 6 1
4 2 1
18 11 1
3 9 2
2 6 2
9 17 2

14 16 0
9 4 0
15 17 0
17 0 0
10 10 1
3 10 1
15 10 1
10 16 1
14 11 2
6 12 2
12 0 2
