width 20
height 20
@@@@@@@@.@.@@.@.@...
.@@@@@@..........@@.
..@@@@@@.@.@@.@@....
.@@@.@...@@..@@..@.@
...@.@.@....@@@@..@@
.@......@.@..@@..@.@
@..@.@.@..@.@@@@....
.@.@@.@@@.@..@...@.@
.......@.@.@@@@@@...
@.@.@.@....@@@.@.@.@
@@.@.@.@.@..........
.........@@.@.@.@.@.
@@.@.@@.@@.@.@@@...@
...@@@@@.........@.@
.@....@.@.@@.@.@..@@
..@.@.@.....@.@..@@@
@@@.@.@.@.@....@..@@
.....@..@@..@.@..@.@
@.@.@@@...@@...@....
...@@...@...@.@..@.@
11
5 5 0
0 11 0
15 15 0
17 10 0
2 13 1
6 11 1
3 16 1
16 13 1
3 17 2
6 5 2
16 3 2

5 14 0
8 4 0
2 7 0
16 6 0
2 19 1
1 6 1
15 19 1
0 19 1
2 12 2
14 14 2
0 4 2
