width 20
height 20
@.@@@....@@@@@@@@...
...@..@@.@@@@@@@..@.
@@..@...@@@@@@@@.@..
@.@.@@.@@@@@@@@.@.@.
.........@.@........
.@.@@.@.@@..@.@.@.@.
..@...@@@.@.@..@@@..
.@..@@........@.@@@.
@.@..@.@.@.@@.@.....
....@.@@..@@..@.@.@.
.@@......@@@@.@@.@..
...@.@.@.@@@@@@....@
.@.@@.@.@.@@@@@@.@..
@..........@.@....@.
.@.@.@.@.@@....@.@..
..@@..@....@.@.@@.@@
@.@..@@@.@.@@.......
....@@@...@@@@@@.@.@
@.@...@.@..@@@@@@@..
..@@.@@@@@.@@@@@...@
11
3 6 0
0 15 0
18 0 0
2 17 0
9 17 1
11 6 1
3 3 1
16 10 1
19 3 2
0 4 2
6 10 2

2 9 0
18 4 0
13 4 0
10 19 0
8 14 1
16 11 1
3 2 1
17 1 1
9 13 2
14 14 2
13 6 2
