width 20
height 20
@.@@@@@.@..@....@..@
...@@.....@@@.@.@.@.
.@...@@@@..@...@@...
@.@.@.@.@.@.@.@@.@@.
....................
@.@@.@.@.@.@.@.@.@.@
....@@@@@@@..@..@..@
.@.@.@.@.@.@@.@.@@@.
@..........@...@.@..
@@.@.@.@.@...@.....@
@...@@..@@@.@@@@.@..
@@@...@.@..@.@..@..@
@...@@.@.@.....@.@..
@@.@@@.....@.@.@...@
@@@@@.@.@.@.@@.@.@@@
@@.@.....@.....@.@..
.....@.@@@@@.@....@.
@.@.@.@@@@@@@..@.@@.
@@....@@@@@@..@.....
@@@.@.@@@@...@@@.@@.
11
4 11 0
9 13 0
13 3 0
6 5 0
19 4 1
16 14 1
12 18 1
4 16 1
19 3 2
11 6 2
4 5 2

2 16 0
14 9 0
16 18 0
6 4 0
14 6 1
14 12 1
10 5 1
10 8 1
6 13 2
2 10 2
3 17 2
