width 20
height 20
..@....@.@.@@@..@@@@
@..@.@.....@@..@@@@@
..@@@..@@@@@.@..@@@@
@..@.@.@..@....@@@@@
@@.@....@...@.@@.@@@
@...@@.@.@.@.@....@@
.@.@.....@.....@.@@@
.....@.@...@.@..@@@@
@.@.@@.@@@..@.@@@.@@
@@@@....@..@........
.....@.@.@@..@.@.@.@
.@.@.@.@..@.@@@...@.
.@@@@.@.@....@@@@...
..........@.@.@...@.
@.@.@@.@.@.@....@..@
@@....@@@....@.@..@.
@.@.@@@@@@.@..@..@..
......@@@@.@.@@@.@.@
@.@.@@@@@@@@@@@..@.@
...@@@@@@@@@@@@@....
11
16 9 0
17 15 0
19 9 0
6 9 0
18 18 1
2 13 1
15 2 1
14 0 1
1 19 2
19 15 2
13 14 2

17 12 0
9 3 0
10 7 0
3 18 0
2 10 1
0 11 1
3 14 1
10 14 1
3 10 2
2 19 2
9 9 2
