width 20
height 20
@...@..@.@@........@
@@@.@@.....@.@.@.@..
....@.@@@.@..@@@@..@
.@@...@....@..@@.@@@
@.@@@.@@.@..@......@
..@.@.@.@..@.@.@.@.@
@.@.@.....@....@@@@@
@.@...@.@...@.@@@@@@
....@.@@.@@..@.@@@@@
@.@.@@...@@@....@@@@
...@...@..@.@@.@@@@@
@.@@@.@@.@...@@@@@@@
@..@@@@@...@@@@@@@@@
@.@.@.@..@@@@@@@@@@@
@.....@@.@@@@@@@@@@@
..@.@....@@@@@@@@@@@
@@@@..@@@@@@@@@@@@@@
@@@@@.@@@@@@@@@@@@@@
@@@@@@@@@@@@@@@@@@@@
@@@@@@@@@@@@@@@@@@@@
11
7 13 0
12 1 0
4 14 0
7 7 0
11 2 1
9 3 1
2 8 1
9 2 1
5 5 2
13 6 2
8 15 2

6 1 0
12 3 0
16 1 0
14 8 0
6 15 1
6 9 1
8 11 1
1 6 1
5 10 2
7 5 2
1 12 2
