width 20
height 20
@@@..@@@.....@......
@@@.@.@..@.@...@@@.@
@@.....@.@@..@.@....
@@@.@.@...@.@..@.@.@
@@@@...@.@@..@..@...
@@@.@.@...@.@..@@@.@
@@..@..@.@.@.@@@@...
@.@...@@......@@..@.
....@@...@.@.@@@@@..
@.@@...@@@@...@@...@
.....@.@.@.@.@...@..
@.@.@.@....@..@@@@@@
@@.@....@@...@@@@@@@
...@@.@.@..@@@@@@@@@
.@..@.@@..@.@.@@@@@@
@..@...@.@......@@@@
@@...@.@.@.@@.@..@@@
..@.@.@.@.@@.@..@.@.
@..............@....
..@.@.@.@.@@.@...@.@
11
12 7 0
12 15 0
0 17 0
6 2 0
8 3 1
10 12 1
5 3 1
14 18 1
2 6 2
5 19 2
4 18 2

10 10 0
8 10 0
8 3 0
8 7 0
8 5 1
9 0 1
1 7 1
3 10 1
9 11 2
17 9 2
11 9 2
