width 20
height 20
.@@@@@@@@@@@........
.@@@@@@@@@@..@.@.@.@
..@@@@@.@@.@..@@@@@@
.@.@.@...@...@@@@@@@
...@.@@.@@.@@..@@@@@
@@..........@@.@@@.@
...@.@.@.@.@@...@...
@.@.@@..@..@.@.@.@.@
.....@.@@@..........
@.@.@@@@@@.@@.@.@@.@
@@@..@@@@.@@...@@...
....@.@....@@@.@@@.@
@.@.@...@.@.@.@.@.@.
@@....@@............
@@.@@@@@.@.@.@.@@.@.
@.@.@.@.@.@@@@@@@@@.
...........@@.@@@.@.
@.@@.@.@.@..........
..@@@...@..@@.@@.@.@
@.@@@@.@@@@@@@...@..
11
12 10 0
18 17 0
10 6 0
4 16 0
1 7 1
1 8 1
9 5 1
18 10 1
6 7 2
12 14 2
0 6 2

8 11 0
10 6 0
10 5 0
3 15 0
19 0 1
16 17 1
8 6 1
6 7 1
18 13 2
9 7 2
5 13 2
