width 20
height 20
..@...@..........@..
.@.@.@@@.@.@@@.@@@.@
......@..@@@@@..@...
.@.@.@@@...@@..@.@.@
@.@...@..@@.@@......
...@.@.@@@.....@@.@.
.@.......@@.@@@...@@
.@@@.@.@@....@.@@@@@
...@@...@@.@...@.@.@
@@@@.@.@@.@@.@......
@@...@....@.@.@@.@@@
@..@..@.@...........
..@..@@@@@.@@.@.@.@@
.@.@.@@@@.@@@@@..@@@
....@@@@@.@.@.@.@@@@
@@.@@@.@.........@@@
@..@.@..@.@.@.@.@@@@
.@.@...@@..@@@@@@@@@
.....@....@@@@@@@@@@
@.@@..@.@...@@@@@@@@
11
2 8 0
2 6 0
10 8 0
15 2 0
4 17 1
5 17 1
1 5 1
4 19 1
2 1 2
7 18 2
8 18 2

2 8 0
7 11 0
9 7 0
14 3 0
6 10 1
0 14 1
13 10 1
13 5 1
15 14 2
6 16 2
11 6 2
