width 20
height 20
.@.@.@..@..@@@@@@@@@
.......@.@..@..@@@@.
@.@@@.@@...@.@.@.@..
@@@@.....@.........@
@@@@@@@.@..@.@.@.@..
@@@@@....@..@.@.@@@.
@.@@@@@.@@@@....@...
...@@...@.@.@@@...@.
@@.@..@.@....@..@..@
@....@....@.@.@..@@.
@.@.@..@.@.....@....
...@@@.@..@@@@.@.@.@
@.@@...@.@.@....@..@
...@@.@@....@.@.@@..
@.@.@@@@.@.@...@@@.@
@......@@@@.@.@.@@..
@.@.@@@@@@@.@....@.@
.@..@@@@@@....@.@.@.
...@@@@@@@@@.@......
@.@@@@@@@@@@@@@.@.@.
11
15 18 0
1 19 0
4 0 0
15 17 0
14 1 1
5 5 1
16 10 1
3 16 1
4 9 2
19 15 2
6 11 2

18 4 0
19 9 0
19 15 0
18 2 0
2 17 1
18 6 1
10 2 1
12 2 1
15 7 2
16 10 2
5 15 2
