width 20
height 20
.@.@@.@.@@@@@@@@.@@@
........@@.@@@@....@
.@@@.@@..@.@@@.@.@@.
..@@@@.@............
.@.@@...@.@.@.@.@.@.
....@.@.@@.@.@@@@@..
.@.@..@..@.@.@@.@.@.
@....@@@.@..........
..@@@@@@@@@@@.@@.@.@
@.@..@@@.@...@.@@.@.
....@@.....@@.......
@@@...@@.@....@.@.@.
....@@@@..@.@@@@.@..
@.@...@..@@@@@@....@
@@.@.@@@.@@@@@.@.@@.
@@...@@...@@........
@@.@@..@@...@.@.@@.@
.@.@.@.@.@.@.@.@@@.@
.......@........@@..
@@.@.@...@.@.@.@@..@
11
11 3 0
13 7 0
16 0 0
19 3 0
1 5 1
14 10 1
15 15 1
4 15 1
19 2 2
4 17 2
7 6 2

8 18 0
13 10 0
17 4 0
17 1 0
14 19 1
4 15 1
8 7 1
18 3 1
17 13 2
15 1 2
7 15 2
