width 20
height 20
.......@@@@..@@...@@
@.@.@.@@@@..@@..@@.@
..@@...@@.@.@.@.....
@.@@@@.........@@.@@
.@@..@@.@@@@.@.@..@.
..@@..@.@.@.@..@@...
.@.@.@.@......@..@@.
.........@@.@.@@....
.@.@.@.@@..@@@...@@@
..@@@.@.@.@@@.@@.@.@
.@@@@.....@@@.@.....
..@@@@.@@..@...@.@.@
@.@@@@@...@.@.@.@...
..@@@@@.@.....@..@.@
.@.@.@.@.@@.@@.@....
.................@.@
@.@.@.@@.@.@.@@@..@@
@@...@....@....@@@@@
@.@@.@@.@.@@.@@@@@@@
.......@@...@@@@@@@@
11
6 14 0
17 7 0
6 6 0
6 19 0
17 5 1
17 2 1
12 18 1
5 9 1
7 18 2
17 16 2
12 13 2

6 15 0
11 0 0
16 10 0
0 2 0
4 7 1
12 3 1
17 2 1
13 3 1
0 9 2
4 19 2
18 7 2
