width 20
height 20
@@@....@@.@.@.@@@@@@
@@.@.@.........@@@@@
....@@@@.@.@.@.@@@@@
.@@.@.@.@.@@@@..@@@@
@.........@@...@@@@@
..@.@.@.@...@.@.@@@@
@..@..@@@@.@.....@.@
@.@@@.@.@...@@@.@...
@..@@@...@@@.@....@.
..@.@.@.@..@...@@..@
.@........@.@@.@.@.@
...@.@.@@.....@@....
.@@...@...@.@@...@.@
.@.@.@@@.@@..@@.@.@.
@@.@@.@...@.@.......
@..@...@.@@...@.@.@@
.@...@....@.@@..@..@
...@..@@.@@@...@..@.
.@..@@@...@..@..@.@.
@@@...@.@@..@@@.@...
11
11 14 0
0 3 0
11 15 0
12 15 0
1 9 1
15 8 1
2 14 1
14 9 1
14 3 2
7 5 2
10 9 2

5 15 0
11 1 0
11 13 0
8 8 0
1 6 1
4 4 1
12 11 1
10 7 1
13 4 2
9 10 2
1 11 2
