width 20
height 20
@@@@@@@@@@.@@@.@..@.
@@@@@@@@.@.@@@...@..
@@@@@@......@.@@...@
@@@@@@@.@.@.@.@.@@.@
.@.@@@...@......@...
....@.@@@.@@.@.@@@.@
.@@....@...@..@@@...
.@@.@.@@@.@@.@@@.@.@
.@@@...@............
.@@..@.@@@.@.@.@.@@@
...@..@@@@@...@.....
.@@@@..@@@@@.@@@.@.@
.@.@.@.@@@@.@.@..@@@
......@@........@@@@
.@@.@...@@@.@.@.@@@@
...@..@..@...@@@...@
.@@@@@..@@@.@.@@.@.@
..@..@@.@@@...@..@..
@.@.@.@@.@@.@.@@.@@@
............@.......
11
13 12 0
19 1 0
5 19 0
17 15 0
1 18 1
0 10 1
6 16 1
18 16 1
10 2 2
17 10 2
15 4 2

0 13 0
8 18 0
11 13 0
16 2 0
6 2 1
8 13 1
18 10 1
15 19 1
6 11 2
7 17 2
13 19 2
