width 20
height 20
@@@@@@@@@@@@@@@@@@..
@@@@@@@@@@@@@@@@@..@
@@@@@@@@@@@@@@@@@@..
@@@@@@@@@@@@@@@@@..@
@@@@@@@@@@@@@@@@.@.@
@@@@@@@@@@@@@@......
@@@@@@@@@@@@@.@@.@.@
@@@@@@@@@@@@@.@.@@.@
@@@@@@@@@@@.........
@@@@@@@@@@@@.@.@.@.@
@@@@@@@@@@@@@..@@@@.
@@@@@@@@@@@@.@...@@.
@@@@@@@@@@...@@.@.@.
@@@@@@@@@@@@.@......
@@@@@@@@@@@@..@.@.@.
@@@@@@@@@@@@@..@@@..
@@@@@@@@@@@@@.@.@.@.
@@@@@@@@@@@.........
@@@@@@@@@@@@.@@.@.@.
@@@@@@@@@@@@..@..@@@
11
13 14 0
19 12 0
18 5 0
12 11 0
16 8 1
12 17 1
15 7 1
18 9 1
16 11 2
17 18 2
13 17 2

15 12 0
19 0 0
12 11 0
18 0 0
16 19 1
18 15 1
11 12 1
13 17 1
12 13 2
17 5 2
19 15 2
