width 20
height 20
..@...........@.....
@..@.@@.@.@.@...@.@.
..@.@..@.@.@.@.@@@..
@.....@.......@.@.@.
..@.@@@.@.@.@.....@.
@..@@...@..@@.@.@...
..@.@@@..@...@@@.@@.
@....@..@.@@@@@.....
..@@@@@.....@@@@.@.@
.@.@@.@.@.@.@.@.@.@.
.........@@.........
@.@.@@@.@@@.@.@.@.@.
@@...@..@@...@.@@@.@
@@@.@@@.@.@@........
@@@@@@@@@..@.@@.@.@@
@@@@@@@...@..@.@@..@
@@@@@@.@.@.@@.....@@
@@@@@......@.@@.@.@@
@@@@@@.@.@.......@.@
@@@@....@@@.@.@@....
11
13 5 0
6 7 0
8 16 0
15 5 0
18 13 1
10 18 1
16 19 1
17 9 1
13 18 2
2 10 2
15 3 2

9 14 0
7 7 0
11 9 0
6 5 0
1 8 1
14 1 1
4 19 1
8 8 1
6 7 2
17 16 2
7 5 2
