width 20
height 20
...@@.@.@@@..@.@..@@
@@.......@..@@..@..@
@@@.@.@.@.@.@@.@.@..
@@@@@@............@.
@@@.@.@.@.@.@@@@.@@.
@@......@..@@@@.....
@.@.@.@@..@@@@.@.@.@
.....@..@..@@@..@@.@
.@.@.@@.@@.@@..@.@..
.@..@@..@.@..@.....@
..@...@.....@.@@@@..
.@.@@..@.@@......@.@
....@.@@@...@.@@..@.
.@.@.@@..@@..@...@@.
@.......@...@@@.@...
@.@.@@.@@.@@@@@@..@.
@..@..@.@.@@@@.@@@..
..@.@...@.@@@....@@.
@.....@...@@.@.@@...
..@.@.@.@.........@.
11
19 4 0
18 2 0
8 1 0
5 14 0
10 5 1
19 16 1
18 11 1
11 1 1
3 5 2
13 11 2
16 3 2

14 16 0
4 16 0
7 7 0
17 1 0
12 13 1
14 19 1
5 17 1
13 10 1
3 18 2
4 5 2
6 17 2
