width 20
height 20
@@.@@@@@@@.......@..
@...@@@@@..@.@.@@.@.
@@.@@.@@.@..@.......
.......@.@.@@@.@.@.@
@.@.@.@....@@.@@@...
...@...@.@......@.@.
@.@@@.@.@@@.@.@..@..
@@@.....@@@@@.@.@.@.
@@@@@.@..@...@....@.
@@@....@@..@...@.@.@
@@.@.@@@.@..@@..@...
......@...@@.@.@.@.@
.@.@@@@@@......@....
.@@.@....@.@.@...@.@
....@.@@...@@..@..@@
@.@@@@...@@@@.@..@@@
@.@@@.@@...@@..@.@@@
.........@@@@.@...@@
.@@@.@@.@.@@@@@@.@@@
.@@@@......@@@@@@@@@
11
4 17 0
17 17 0
2 17 0
5 14 0
8 13 1
7 17 1
2 2 1
0 18 1
13 16 2
6 7 2
2 0 2

16 12 0
14 3 0
8 4 0
10 2 0
12 12 1
10 3 1
10 13 1
5 16 1
15 2 2
13 9 2
3 17 2
