width 20
height 20
@@.....@...@@@..@@@@
@@@@.@@@@.@.@@@..@@@
@@...........@..@.@@
@@@.@.@@.@@.@.@.....
@@@@...@..@...@.@.@.
@@@@@.@@@.@.@....@@@
@@@@@@.@.@.@.@@.@@@.
@@@@@............@..
@@@@@@.@.@.@@.@.@@@.
@.@@@@..@@.@@@...@..
@..@@.@@.@@.@.@.@@@.
..@@@...............
@..@@@@.@.@@.@.@.@.@
..@.@.@..@...@..@...
@.......@..@@..@@@@.
@@.@.@.@@@@.@@.@....
.@@@@@..@@......@.@.
...@...@...@.@.@.@@.
@.@.@@@@@.@.@.....@.
............@@.@.@..
11
2 19 0
14 17 0
11 2 0
15 8 0
6 0 1
5 0 1
5 13 1
17 2 1
4 14 2
1 13 2
18 11 2

7 16 0
7 11 0
10 11 0
4 14 0
0 17 1
3 0 1
2 2 1
15 2 1
5 14 2
6 2 2
0 16 2
