width 20
height 20
......@@@@.......@..
@@.@@..@@.@.@.@.@@.@
...@..@.@....@@@.@.@
@@@.@.....@.@....@..
@@....@@@.@.@.@@@..@
@@@.@..@.@@@..@@@.@.
@@...@@...@.@..@....
@.@.@@@.@.....@.@.@@
..@..@@@.@.@@.@...@@
@..@.@@@...@.@.@.@@@
..@...@..@........@@
@.@@.@.@..@.@.@@.@..
.........@@@...@@..@
.@.@@@@.@@@.@.@@..@.
@@@......@..@@..@...
.@@@.@@.@.@.@.@...@.
..@.@.@.........@@.@
.@....@.@.@.@.@....@
...@.@.@.@@@.@..@.@.
@.@............@....
11
15 3 0
3 4 0
10 10 0
18 2 0
6 19 1
19 13 1
17 17 1
11 3 1
19 0 2
2 1 2
16 0 2

13 4 0
4 17 0
16 8 0
19 11 0
3 4 1
4 14 1
0 10 1
4 11 1
2 4 2
2 1 2
5 19 2
