width 20
height 20
@@..@.@.@.@.@@@@.@@@
@.@.@........@@..@@@
....@.@.@.@.@..@..@@
@.@@@..@@@@.@@...@.@
......@@@@...@.@@...
@.@.@.@@@@@.@@.@.@.@
..@..@@@@@@.@.......
.@@.@.@@@@...@.@.@@@
@@@...@@@@@.@@@@....
@@@@.@..@@...@@..@.@
@@@@.@.@.@@.@.@.@..@
@@@......@.......@..
@..@@.@.@@@.@.@@@@.@
..@...@....@@.@...@@
@...@.@.@.@@@...@..@
..@..@@@@@@@@.@@.@..
@..@.@@.@.@@.@.....@
..@.@@.........@.@..
@....@@@.@.@.@..@.@.
..@@..@...@@.@.@....
11
0 7 0
17 16 0
18 15 0
7 1 0
7 13 1
5 12 1
10 4 1
14 6 1
0 2 2
4 16 2
10 17 2

18 4 0
11 11 0
18 17 0
8 10 0
3 0 1
4 18 1
6 1 1
3 17 1
16 6 2
7 1 2
19 15 2
