width 20
height 20
@@@.....@.@@..@@.@..
@@@@@.@....@@..@...@
@@@@@@.@@.@@.@.@.@.@
@@@.@...........@...
....@.@.@.@.@@.@.@.@
@.@.@@.@.@@@.@......
.@...@.....@...@@.@.
..@.@.@.@.@.@.@@@@..
@.......@....@@@@@@.
..@.@@.@.@@.@@@@@@..
@..@.......@@@@@@@@.
..@.@@.@@.@@.@@@@@..
@.....@...@...@@@@@.
@@@.@.@.@@.@.@.@....
@@@@...@.@.@.....@@.
@@@@@.@......@.@...@
@@@.....@.@@@@@@@.@@
@@.@@.@..@..@@@@@@@@
.......@.@.@@@@@@@@@
.@@.@.@.....@@@@@@@@
11
7 6 0
12 12 0
4 0 0
14 2 0
11 12 1
18 1 1
9 10 1
10 6 1
14 1 2
8 5 2
8 6 2

18 11 0
5 15 0
11 9 0
11 4 0
12 13 1
10 6 1
9 3 1
7 6 1
8 12 2
14 1 2
18 0 2
