width 20
height 20
@@@..@........@.@@@@
@@@@..@.@.@.@...@@@.
@@@@.@.@@.@@@@@..@..
@@@.........@.@.@.@.
@@@@.@.@@.@@........
@@@@@@...@@@@.@.@.@@
@@@@@..@..@@@@@@@...
@@@@@@.@.@.@@@@.@.@@
@@@@@@@..@.........@
@@@@@...@..@.@@.@.@@
@@@@@@.@..@.@.@..@@@
@@@@@@@..@@...@.@@..
@@@@@..@....@.@@@.@.
@@@@@.@.@.@.@@.@....
@@@@......@.....@.@@
@@@@@.@.@.@@.@@.@..@
@@@@@.@..@..@@@@..@@
@@@@@@..@@.@.@@.@..@
@@@@@@@...........@.
@@@@@@@@@.@@.@@.@...
11
16 10 0
18 19 0
19 1 0
8 18 0
11 14 1
9 1 1
8 16 1
7 5 1
9 12 2
6 7 2
17 12 2

11 12 0
5 13 0
17 15 0
6 3 0
13 0 1
19 12 1
7 9 1
5 15 1
6 5 2
11 1 2
9 15 2
