width 20
height 20
....@.@.@.....@@.@@@
.@@.......@.@@....@.
...@.@.@.@....@.@.@.
@.@...@@..@.@@@@....
@..@@.@@@..@.@@.@.@@
..@.@@@@@@........@.
@@@..@@@@@.@.@.@.@..
....@.@.@.@.@@@..@@.
.@@.......@..@.@.@..
.@..@.@.@...@..@.@.@
@@@@..@..@@...@.....
....@@.@@.@@@..@.@.@
@@@.@...@.@@.@.@@...
@@....@...........@.
...@@.@@.@.@@.@.@.@@
.@...@.@@@@.@@...@.@
@@.@..........@@@...
@@@..@@.@.@.@..@..@.
@@..@....@@@..@.@.@@
@@@@@@@.@@@@@......@
11
18 8 0
17 2 0
6 15 0
17 19 0
18 3 1
19 10 1
2 9 1
1 3 1
13 9 2
7 13 2
15 15 2

0 1 0
15 19 0
10 2 0
19 8 0
13 16 1
6 11 1
8 10 1
19 5 1
1 2 2
5 12 2
1 14 2
