width 20
height 20
@@@@@@@@@@@@@@@@@@@@
@@@@@@@@@@@@@@@@@@@@
@@@@@@@@@@@@@@@@@@@@
@@@@@@@@@@@@@@@@@@@@
@@@@@@@@@@@@@@@@@@@@
@@@@@@@@@@@@@@@@@@@@
@@@@@@@@@@@@@@@@@@@@
..@@.@@@@@@@@@@@@@@@
@....@@@@@@@@@@@@@@@
..@.@.@@@@@@@@@@@@@@
@@.....@@.@@@@..@@@@
..@.@.@.....@.@.@@@@
.@.@...@.@.@....@@@@
....@@..@....@.@@@@@
@@@....@..@@.@@@@@@@
....@.@..@.@.@.@@@@@
@@.@.@@@.@.....@@@@@
........@@@.@@..@@@@
@.@@.@.@.@.@.@.@.@@@
...@@@...........@@@
11
12 12 0
5 12 0
15 19 0
7 15 0
8 14 1
1 7 1
7 11 1
12 19 1
8 12 2
9 19 2
13 11 2

2 16 0
8 16 0
15 17 0
15 19 0
13 19 1
1 7 1
8 12 1
4 7 1
14 10 2
4 8 2
0 19 2
