width 20
height 20
@@@@@@@@@@@@@@@@@@@@
@@@@@@@@@@@@@@@@@@@@
@@@@@@@@@@@@@@@@@@@@
@@@@@@@@@@@@@@@@@@@.
@@@@@@@@@@@@@@@@@@..
@@@@@@@@@@@@@@@@@.@.
@@@@@@@@@@@@@@@@....
@@@@@@@@@@@@@@@@@.@.
@@@@@@@@@@@@@@@@...@
@@@@@@@@@@@.@.@.@.@.
@@@@@@@@@@..........
@@@@@@@@@.@@@.@.@.@.
@@@@@@@@....@..@@@..
@@@@@@@@@.@.@.@@@.@.
@@@@@@@@@@.....@@...
@@@.@.@.@.@.@.@@@@.@
@@..........@.@@@@@@
@..@@.@.@.@@@@@@@@@@
..@@...@...@@@@@@@@@
.@@@@.@@.@@@@@@@@@@@
11
5 15 0
6 16 0
17 13 0
10 18 0
17 6 1
14 12 1
2 16 1
19 5 1
7 16 2
17 10 2
16 10 2

18 15 0
12 14 0
14 12 0
9 18 0
10 14 1
1 18 1
13 16 1
13 10 1
13 9 2
7 15 2
17 8 2
