width 20
height 20
.........@..@@@@@@@@
.@.@@@@@@.@..@@@@@@@
..@...@.@.@.@.@..@@@
.@.@.@.........@.@@@
.@.....@.@.@@.@@....
.@.@.@.@..@@...@@.@@
....@.@..@@.@@......
.@.@@.@@....@.@@.@.@
@@@......@.@....@.@@
..@@.@.@.@@@.@@....@
@.@@..@.@.....@@.@..
.....@..@.@@@.@@@..@
.@.@.@.@.@.@.@.@.@..
..@@@.............@.
.@....@.@.@.@.@.@...
...@.@.@.@@@@@@@.@.@
.@@@...@.@@.@.......
@...@.@.......@.@@.@
@@.@.@.@.@@.@@..@.@@
..........@...@...@@
11
19 4 0
7 14 0
17 11 0
0 11 0
5 16 1
9 14 1
17 4 1
12 19 1
2 7 2
6 5 2
4 4 2

18 17 0
11 18 0
1 15 0
18 12 0
6 0 1
4 19 1
14 6 1
12 12 1
15 2 2
4 10 2
3 19 2
