width 20
height 20
@@.@@@@.@@@@@@@@@@@@
@@..@@..@@@@@@@@@@@@
@..@...@@@@@@@@@@@@@
.@.@.@@@@@@@@@@@@@@@
.......@@@@@@@@@@@@@
.@.@.@.@@@@@@@@@@@@@
..@@@@@@@@@@@@@@@@@@
.@.@.@.@@@@@.@..@..@
.......@.@@@..@...@.
.@.@.@....@..@..@...
..@@@.@@.@.@..@.@.@.
.@@@@........@.@.@@.
...@..@.@.@.@.......
.@@@@.@@...@.@.@.@@.
.@@@....@.@@...@@@.@
@@@..@.@.@...@......
@@@@..@....@..@.@.@.
@@@@@..@.@..@@.@.@..
@@@@@@.@.@@....@.@@.
@@@@@....@..@.@@....
11
14 9 0
15 12 0
19 19 0
3 8 0
0 13 1
9 12 1
2 2 1
15 16 1
4 4 2
6 11 2
9 14 2

16 17 0
17 15 0
0 6 0
8 10 0
7 11 1
12 10 1
7 1 1
15 16 1
18 15 2
16 18 2
3 8 2
