width 20
height 20
@@.@.@..@@@....@@@@@
......@.@@..@@.@.@@@
@.@.@....@.@...@..@.
@.@@..@.@.@@@@...@..
.@..@..@...@.@.@.@@.
..@.@.@.@@......@.@.
.@.......@.@@@@@....
.@@.@.@@......@.@.@.
..@@.@.@.@.@@......@
.@.@......@.@@.@@@.@
.....@@.@.@...@.@.@@
.@.@..@@.@..@......@
@@@@.@....@@@@.@.@..
@@@....@.@..@.@.@.@.
@@@@.@..@..@..@.....
@@@@@..@.@.@.@.@@.@.
@@@@@@.............@
@@@@@@@.@@.@.@@.@.@@
@@@@@@@...@@@@...@@@
@@@@@@@.@.@@@@@.@@@@
11
14 5 0
8 12 0
16 8 0
8 15 0
9 19 1
14 4 1
10 7 1
5 4 1
14 18 2
14 12 2
19 13 2

17 11 0
10 5 0
11 11 0
6 16 0
9 7 1
8 11 1
9 4 1
19 12 1
15 16 2
11 0 2
17 2 2
