width 20
height 20
..@@@..@@@@.@.......
.@.@.@.@@@@...@.@.@.
.@.@.....@.@@..@.@@@
.@...@.@@..@..@...@@
...@@....@..@...@@@@
.@.@.@.@.@.@.@@..@.@
..@.....@@.....@.@..
@..@.@.@.@.@.@.@.@@.
..@@@@......@.......
@@@@@@.@.@.@@@.@@.@.
.@.@@.@@@@@.@.@....@
.@.....@.@......@.@.
...@.@.....@.@@.@...
.@..@@@@.@.@...@.@@.
@..@.@..@@@..@...@..
.@.....@.@..@..@.@.@
.@.@.@....@@@.@@..@.
..@.@..@.@.@@@...@@.
@.....@..@.....@....
@@@.@..@.@@.@@..@.@.
11
3 13 0
19 0 0
6 0 0
10 11 0
0 0 1
11 6 1
15 17 1
2 18 1
3 17 2
0 5 2
13 10 2

8 7 0
8 5 0
10 17 0
16 5 0
15 11 1
10 5 1
5 2 1
16 2 1
3 3 2
10 4 2
6 12 2
