width 20
height 20
.....@.@@..@@.@.@.@@
.@.@...@.@.........@
@.@..@@....@.@@.@.@.
@.@@.@.@.@@@.@@@....
@...........@.@.@.@@
.@.@@.@.@.@......@@@
.....@...@..@.@.@.@@
@.@.@@@.@@@..@....@@
..@@.@@.@@@.@.@.@..@
@@.@.@.@.@.@@.@@..@.
................@...
.@.@.@.@.@@@.@.@.@@.
.@@.@@@.@@@@@.......
..@.@.@.@@@@@@.@@.@.
.@.......@@@@....@..
.@@.@.@.@.@@.@@.@.@@
@.@@@@..@...........
....@@@...@.@.@.@.@@
@@@.@@.@.@@@..@@....
@.........@@@..@.@.@
11
7 19 0
13 18 0
3 13 0
8 3 0
19 3 1
4 10 1
15 17 1
6 19 1
2 10 2
17 12 2
9 4 2

6 19 0
13 1 0
6 16 0
12 10 0
18 10 1
8 11 1
0 11 1
3 4 1
14 5 2
0 6 2
0 10 2
