width 20
height 20
@@..@@.........@....
@..@.@@.@.@.@.@.@.@.
@@......@@@@@@@...@.
@.@@.@@...@@@@@@.@@.
..@@...@@@@.@.@@.@..
@.@@.@..........@.@.
..@.@@@.@.@.@.@.....
@...@@@.@@@@@.@.@.@@
..@@@@.@@..@.@.@..@@
@..@......@......@@@
@.@@@@@@@.@.@.@.@@@@
.....@....@..@.@.@@@
.@@@@@@.@...@.....@@
.@.@.@.@@.@.@@.@@@.@
...........@...@....
@@@.@.@.@.@@@@...@.@
.....@...@.@.@.@@...
@.@.@.@@.........@@.
.@..@....@@@@.@.@@..
...@@.@.@@@@@@....@.
11
7 1 0
2 2 0
0 18 0
3 15 0
14 12 1
10 12 1
8 18 1
19 18 1
6 5 2
4 9 2
3 11 2

3 11 0
19 19 0
2 18 0
15 6 0
3 2 1
6 16 1
13 0 1
16 3 1
8 18 2
9 9 2
18 0 2
