width 20
height 20
@.@.@...@..@@@@.@...
.....@.@..@@@.....@.
.@.@....@..@@@.@@@..
@..@.@.@..@.@.@.@.@.
@.@...@@@...........
@@.@.@.@.@@.@@.@.@@@
@............@@..@@@
.@.@.@@.@.@@.@@@.@@@
....@@@@@@@.@.@..@@@
.@@.@@@@@@....@@.@@@
.@.@.@@.@.@.@.@...@@
............@@@@.@.@
.@.@.@.@@.@.@...@...
..@...@..@@@@.@..@.@
@@@@@.@.@.@.@@@.@...
..@...............@.
@.@.@.@.@.@@.@.@.@..
.....@@@....@@@.@.@.
.@@.@.@@.@@@........
@.......@@@@@.@.@.@.
11
8 13 0
13 19 0
0 17 0
15 4 0
0 8 1
8 11 1
18 13 1
11 17 1
1 17 2
11 15 2
6 5 2

5 18 0
18 0 0
17 0 0
13 18 0
0 9 1
5 14 1
6 6 1
17 3 1
16 18 2
17 1 2
1 8 2
