width 20
height 20
@@@@@@@@@@@@@@@@@.@@
@@@@@@@@.@@@@@@@..@.
@...@@@....@..@@@...
@@.@.@.@.@@.@..@..@.
@.............@@@..@
.@.@.@.@@@@.@@@@..@@
....@@...@.@@.@.@...
.@.@@@.@@.........@.
.@.@@@..@.@.@.@.@@.@
..@.@.@....@@@......
.@.....@.@..@@@.@@.@
.@@.@.@.@.@@.@.@@..@
@...@......@...@.@..
..@@@@@.@.@@.@...@.@
@...@@@@...@.@.@....
..@@@@..@.@...@..@.@
@..@@@.@...@.@.@..@@
@@.@@....@.@.@...@@@
@@@...@.@....@@@....
@@@@@..@@@.@...@.@.@
11
5 12 0
16 3 0
5 9 0
12 14 0
19 7 1
4 3 1
1 15 1
17 5 1
9 7 2
17 2 2
8 9 2

1 4 0
16 3 0
17 4 0
8 4 0
10 10 1
19 18 1
11 4 1
5 11 1
9 13 2
11 7 2
4 10 2
