width 20
height 20
@@@@@@@.@.....@...@.
@@@@@....@.@@.@.@...
@@@...@@..@....@.@.@
.@..@.@.@@@@.@......
.@.@.....@..@.@@.@.@
..@.@.@@.@@...@@..@@
.@....@.....@....@@.
...@.@@@@.@..@@.@@@.
@@.@@.@@@@..@.@.....
@@......@.@.@.@@.@.@
@@.@.@@@....@.@@@...
@.@...@@@.@@@..@@.@.
....@..@..@.@.@..@..
@.@..@..@.......@..@
...@@..@.@.@.@@..@.@
@@.@.@....@.@.@.@.@.
.@@....@.@..........
....@.@@@@@.@.@@.@@.
.@.@@@@@@@@@.@@.@...
.@@@@@@@@@@.......@.
11
11 17 0
8 16 0
6 14 0
11 0 0
1 11 1
15 13 1
16 19 1
19 12 1
4 9 2
15 6 2
18 18 2

11 10 0
18 18 0
0 7 0
3 2 0
2 9 1
12 0 1
19 16 1
5 6 1
3 3 2
18 10 2
10 6 2
