width 20
height 20
@@@@@.@@@@.@@@@@@@@@
@@@.@..@@@.@@@@@@@@@
.@....@.@@.@.@@@@@@@
...@.@........@@@@@@
@@.@...@.@@@.@.@@.@.
...@.@@@@.@@........
@.@@@.......@.@.@.@.
...@..@.@.@.@.@@.@@.
@.@@@.@..@@.@@@.....
...@@@@@@.@.@@@@.@@.
@.@@@.@@....@@@....@
..@@@....@.@.@.@.@..
@.@@..@.@@.@....@@@.
..@@@..@@@@.@@@..@..
@@.@@.@.@@@...@@.@@.
.@..........@.......
...@.@.@.@.@@@.@@@@.
.@.@..@@@@@@@@..@@@@
..@@@@@@@@@@@@@.@@@@
.@@@@@@@@@@@@@@@@@@@
11
10 6 0
11 15 0
19 9 0
7 12 0
7 14 1
10 3 1
19 15 1
12 11 1
10 10 2
15 13 2
12 12 2

5 13 0
8 3 0
17 8 0
7 11 0
2 5 1
12 11 1
1 3 1
12 14 1
1 11 2
8 6 2
13 14 2
