width 20
height 20
@@@@@@@@........@.@@
@@@@@@@@.@.@@.@.....
@@@@@@@@@....@..@.@@
@@@@@@@@@@.@@@@.@.@.
..@@@@@@@@@@@@@@....
.@@@@@@.@@@@@@@@@.@.
..@@.@...@@@..@@@@@.
.@.....@@@@..@@@@...
...@.@.@@@.@.@.@.@.@
@@..@.@.@..@........
@..@......@@.@.@.@.@
@@.@@.@@.@.@@.@.@...
@......@......@.@@.@
@@.@@.@@@.@.@.......
@@...@@@@@...@.@@.@.
@@.@@@@@...@.@...@..
@@@@@@@..@.@@.@@@.@.
@@@@@@..@@@...@.....
@@@@@@.@@@.@@...@@@.
@@@@@@@@......@.@...
11
8 15 0
9 2 0
14 18 0
16 4 0
9 9 1
17 13 1
2 13 1
19 19 1
2 11 2
5 7 2
12 0 2

4 8 0
16 13 0
0 6 0
17 4 0
15 3 1
2 14 1
13 17 1
8 12 1
0 4 2
19 11 2
14 14 2
