width 20
height 20
..@.@.@..@@@@@.@@@@@
@......@..@@@...@@@@
@@.@@.@.@.@@@@.@@@@@
@.@.............@@@@
...@.@@.@.@.@@.@@@@@
@.@...@@.@@.@.@@@@@@
...@.@@@.......@@@@@
@.@..@@.@.@.@@..@@@@
..@@....@@.@@.@..@@@
@..@.@.@@.......@@@@
.@.@@@.@..@.@.@.@@@@
.@.@.@.@@..@@@.@.@@@
.@.......@........@@
...@.@.@.@@@.@.@.@..
.@.@@.@....@@...@..@
..@.@.@@.@.@@@.@.@..
@.....@@@..@@....@.@
@@.@.@@@..@@.@@@.@..
@@@..@.@@.@......@.@
....@......@.@.@....
11
11 7 0
9 2 0
14 0 0
19 17 0
11 4 1
2 12 1
6 3 1
16 11 1
5 16 2
17 19 2
9 17 2

14 12 0
12 19 0
3 19 0
3 18 0
11 4 1
13 16 1
16 8 1
6 12 1
1 9 2
4 8 2
15 8 2
