width 20
height 20
.@@@@@..@@..@@@@..@.
..@.@.@.@.@..@@..@..
.@..@.......@.@.@.@.
...@.@.@@@.@........
@@......@...@.@.@.@.
.@@@.@.@@@.@@@.@@@..
....@...@@@..@.@@.@.
@.@.@@.@.@.@........
...@@........@@.@.@.
@.@..@.@.@.@.@..@@.@
..@.@@@...@..@@....@
.@...@@@.@@.@@@@.@.@
...@@.@.@..@@@@@@@.@
.@....@...@@@@@@@@..
@.@.@.@@@.@.@@@@.@.@
...@...@@...@@@.....
@.@@@.@.@.@@.@.@.@.@
.................@@@
@.@.@.@.@.@.@.@.@@@@
@@@@...@@.@@@..@@@@@
11
13 17 0
11 8 0
0 11 0
4 5 0
10 15 1
2 15 1
19 6 1
16 17 1
7 12 2
4 15 2
6 0 2

19 7 0
17 7 0
19 4 0
11 10 0
2 2 1
1 3 1
9 19 1
10 2 1
7 8 2
2 6 2
12 10 2
