width 20
height 20
@@@@@@@@@@@@@@@@@@@@
@@@@@@@@@@@@@@@@@@@@
@@@@@@@@@@@@@@@@@@@@
@@@@@@@@@@@@@@@@@@@@
@@@@@@@@@@@@@@@@@@@@
@@@@@@@@@@@@@@@@@@@@
@@@.@@@@@@@@@@@@@@@@
@@..@@@@@@@@@@@@@@@@
@@@.@.@@@@@@@@@@@@@@
@@.....@@@@@@@@@@@@@
@@@.@.@@@@@@@@@@@@@@
@@...@.@@@@@@@@@@.@@
.@.@....@..@@@@@@...
..@.@@.@..@....@@@.@
@.......@...@.@@@@..
@.@@.@.@..@.@.@@@..@
@...@.@@.@.@.@.@.@.@
..@@................
@....@.@@.@.@@@@.@.@
..@.@...@.@@@....@..
11
6 18 0
9 15 0
4 9 0
5 8 0
1 16 1
12 16 1
16 17 1
19 12 1
3 8 2
12 17 2
7 19 2

4 9 0
13 13 0
3 9 0
4 12 0
9 19 1
10 17 1
14 17 1
12 16 1
18 19 2
0 13 2
9 12 2
