width 20
height 20
...@..@@.@.@...@@@..
.@..@..@....@.@.@.@.
@.@.@.@.@@@.........
@.....@.@.@.@@@.@.@@
@@.@@......@.....@@@
@.@...@.@.@.@.@@.@@@
...@.@@@.......@....
@.@.@.@.@.@.@.@.@.@.
..........@@....@@.@
.@@.@@.@.@@@@@@.@@..
.@.@..@@@.@.@.@@@@.@
.....@@@@.....@@@...
@.@.@@@@..@.@.@@.@.@
@@....@.@..@........
@.@.@.@...@.@.@@@@@@
....@.@.@.@....@.@.@
@.@..@...@@@.@......
..@@...@.@@.@..@@.@.
.@@.@.@@@.....@....@
@.....@@@@.@.@..@.@@
11
8 0 0
8 12 0
18 18 0
11 2 0
5 8 1
16 12 1
0 9 1
3 3 1
13 2 2
3 9 2
8 6 2

11 3 0
1 8 0
5 17 0
0 6 0
3 13 1
13 2 1
11 12 1
19 13 1
4 10 2
12 15 2
19 11 2
