width 20
height 20
...@.@@@@@..........
@.@..@@.@@@.@.@.@@.@
....@.....@.@@@@@...
@.@.@.@.@@.@..@@@@.@
.@....@......@.@@...
...@@.@@.@.@....@@.@
.@...@@@@@@@@@.@@...
..@.@@@@.@.@@@@@.@.@
@..@.@@..@.@@@.@.@..
@@.....@....@......@
@@@@.@...@.@.@.@.@@@
@@.@.@.@@@@@..@..@..
@..@@@.@.@...@.@.@.@
.@..@....@.@........
...@@@.@.@@..@@.@.@.
@.@.@.@....@..@.@@@@
.......@.@@.@..@@@@@
@.@.@@.@......@@@@@@
...@@....@@.@@@@@@@@
.@..@@@@.@@.@@@@@@@@
11
19 11 0
10 12 0
16 10 0
1 16 0
10 4 1
13 16 1
5 18 1
14 8 1
5 4 2
19 14 2
10 7 2

13 5 0
13 15 0
16 11 0
0 6 0
15 1 1
13 1 1
8 17 1
12 17 1
3 2 2
7 4 2
17 9 2
