width 20
height 20
@@@@.@.@....@..@@..@
@@@....@@.@@.@.@.@..
@@.@.@.............@
......@.@.@@.@.@.@@.
@.@.@@.@.@@..@@..@..
...@@@.@..@@.@@@...@
@.@.@@.@.@@@@@@@.@@@
@.@.@....@@@@@@@@@@@
......@@.@@@@@..@@@@
@.@.@...@@@.@@@..@@@
...@@.@..@...@..@@@@
@.@@.@..@.@.@.@.@@@@
@@@...@.......@..@@@
@..@@...@@.@@.@.@@@@
.@.@..@.@.@@@....@@@
....@.@@......@.@@@@
.@.@@@...@@.@..@@@@@
..@..@@@.@@.@.@.@.@@
.@.@.....@@@........
.....@.@@@@@@.@.@.@.
11
14 16 0
1 10 0
0 8 0
8 8 0
19 3 1
0 10 1
16 3 1
2 19 1
15 19 2
11 2 2
19 4 2

3 3 0
6 19 0
9 12 0
7 12 0
16 9 1
3 15 1
4 3 1
19 4 1
2 8 2
2 2 2
8 2 2
