width 20
height 20
@.@.....@..@@@@@@@@@
....@.@.@@..@@@@@@@@
@.@@.@.@.@.@.@@@@@@@
.........@...@@@@@@@
@@.@.@@@...@..@@@@@@
@@@@@...@.@..@@@@@@@
.@.@.@.@.@.@.@@@@@@@
.............@@@@@@@
.@@@@.@.@.@@.@.@.@@@
.@.@.@.@@@@@...@..@@
........@.@.@@@@@..@
.@.@.@.@@.....@@..@.
..@@@.....@.@..@@...
.@@@@@@.@.@.@.@.@@@.
@@@@@@@..@@.@....@..
@@@@@@..@...@.@.@.@.
@@@@@@.@..@.@@......
@@@@@@@@@..@@@@.@.@.
@@@@@@@@@@@@@@@@..@.
@@@@@@@@@@@@@@@@.@..
11
9 10 0
3 10 0
2 11 0
3 0 0
19 12 1
4 3 1
3 1 1
16 14 1
9 16 2
4 0 2
12 6 2

0 11 0
10 17 0
3 10 0
6 2 0
17 12 1
7 14 1
11 7 1
9 15 1
18 12 2
5 1 2
11 3 2
