width 20
height 20
@@.@.@@@.....@@@.@@.
......@.@@.@@.@.....
@.@.@...........@.@@
...@..@.@@@@@.@@.@@@
@.@.@@.@@@.@.....@@@
.......@@@.@@.@@.@@@
.@@@.@..@...@.@.@.@.
@@@@@..@.@.@.@......
@@@@.@.@.......@@.@.
@@@......@.@.@.@.@@.
@@@.@.@@.@@.@.@..@..
@@@@....@.@.@.@.@.@.
@.@.@.@.......@.@...
....@.@.@.@.@...@.@.
@.@@.@@@..@..@@..@..
......@..@.@..@.@.@.
.@@@.@.@.@...@@...@.
@........@@@.@@@.@..
.@.@@@.@@@@@@@@..@@@
...@@@...@@@@@@@@@@@
11
16 16 0
13 12 0
12 17 0
11 12 0
4 17 1
6 5 1
15 18 1
13 2 1
6 4 2
15 2 2
19 0 2

0 19 0
12 15 0
13 4 0
15 2 0
5 2 1
3 12 1
6 2 1
17 15 1
1 13 2
12 8 2
7 11 2
