width 20
height 20
..@@@@.@@@@@.@@@@@.@
@...@....@@...@@@...
..@@.@@.@.@@.@.@.@@.
@.@@................
.....@.@@.@@.@@@.@.@
.@@@..@..@@...@...@@
@@@@.@.@...@.@@@.@..
@@@@@@...@....@@@@@.
@@@@...@.@@@.@@@@@..
@@@..@.@@.@@@@@@@.@.
@@@@..@.............
@@@..@..@.@.@.@.@.@.
@@@@.@.@.@.@@@@@@.@.
@@@...........@....@
@@.@.@.@.@@@.@..@.@@
@..@@..@@..@@..@.@@@
@@..@@..@@.@@@....@@
@..@.@.@.......@.@.@
@@......@.@.@@.@....
@@.@.@.@@@..@..@.@.@
11
18 10 0
19 3 0
19 6 0
6 17 0
18 17 1
3 18 1
12 5 1
9 9 1
8 12 2
9 18 2
12 3 2

0 5 0
6 6 0
0 4 0
8 5 0
9 18 1
7 1 1
10 16 1
17 3 1
5 18 2
15 10 2
6 13 2
