width 20
height 20
....@@.@....@.@..@@.
@@.@@...@.@.....@.@.
....@@@....@@.@.....
@.@..@..@.@.@@.@.@.@
...@.@@@.@@.....@...
.@@...@@....@@.@@@.@
@@.@@....@.@@.......
......@.@..@@@.@.@@.
@.@.@@.@@@@@@@@@@...
..@@@@..@.@@@@@@..@.
@.@@@@@....@@@@@@@..
@@@@@@@@@.@.@.@@@@.@
@@@@@@@@@......@@@..
@@@@@@@@@.@.@.@.@..@
@@@@@@@@.@@.@....@..
@@@@@@@@..@..@.@...@
@@@@@@@@@...@...@@..
@@@@@@@@.@.@.@.@@@@.
@@@@@@.......@@@@...
@@@@@..@.@.@.....@.@
11
11 4 0
6 8 0
11 11 0
11 12 0
9 2 1
18 18 1
3 7 1
4 3 1
12 4 2
19 2 2
16 0 2

11 14 0
0 7 0
3 5 0
6 8 0
13 14 1
10 0 1
10 17 1
18 6 1
5 7 2
3 0 2
15 4 2
