width 20
height 20
@.@@@.@@.@..@..@@@..
...@...@..@..@.@.@.@
.@.@@@...@.@.@......
@......@.......@.@@@
@@.@.@.@.@.@@.@...@@
@@@...@@@....@@@.@.@
@@@@.@@@@@.@...@....
@@....@@@@@..@@..@.@
...@.@@@@@..@@.@@...
.@.@@.@.@.@.@....@.@
..@@..........@.@@@@
.@@@@.@.@@@.@@.@@@@@
@@@@@..@...@....@@..
@@@@@.@..@..@.@.@.@.
@@@@@..@@.@.@@......
@@@@.@......@@@.@.@@
@.@....@.@.@@.@.@...
....@@@@@@.......@.@
@.@.@......@@.@.@@@@
@@@@@@.@@@.@@@...@@@
11
17 4 0
5 3 0
2 4 0
4 10 0
12 1 1
13 18 1
7 9 1
9 14 1
5 0 2
8 16 2
15 15 2

18 14 0
16 4 0
4 8 0
16 5 0
11 15 1
9 10 1
1 10 1
10 3 1
7 15 2
6 15 2
11 3 2
