width 20
height 20
.@..@...@.@@@@......
...@..@.@..@@.@.@.@.
.@@.@..@..@......@@@
......@@.@.@.@@.@.@.
.@.@.@.......@@.....
..@@@.@.@.@.@@.@@@@.
.@.@..@@@@@@....@@@.
.....@.@@.@..@.@.@@.
@.@@........@@......
@@..@@.@.@.@@@@.@@@.
@.@.....@@@....@@@..
@...@.@.@@@.@.@.@..@
@.@@.@.@.@@@......@@
..........@@.@.@.@@@
.@.@@@@@.@.@..@@@.@@
..@.@@@@@@..@.......
@...@@@....@@@.@@.@.
..@..@.@@@...@.@...@
.@.@...@.@.@@...@.@.
@....@.......@.@@...
11
2 16 0
4 12 0
4 17 0
2 6 0
14 15 1
5 11 1
2 13 1
19 3 1
5 8 2
9 7 2
6 19 2

15 8 0
5 1 0
14 16 0
14 0 0
13 6 1
13 1 1
0 13 1
2 19 1
13 18 2
19 10 2
4 18 2
