width 20
height 20
@@@@@...@@@@@@@@@@@@
@@@@@.@.@@@@@@@@@@@@
@@@@...@.@@@@@.@@@@@
@.@.@.@...@@@...@@@@
......@@.@.@.@.@.@@@
@.@.@@............@@
@@....@@.@.@.@@@.@.@
@@@.@@..@@@@@@@.....
@......@.....@.@@.@@
@@@@.@...@.@@@....@@
@@....@@..@@@@@.@.@@
@@.@@@@@.@.@.@...@.@
@.....@........@....
.@@@.@@@@.@@.@.@@.@@
......@@@@..@@@@@@@@
.@.@.@@@@@.@@@@@@@@@
.@..@@@@@...@@@@@@@@
@..@@.@@@.@@@@@@@@@@
.@......@.@@@@@@@@@@
...@@@@....@@@@@@@@@
11
10 8 0
13 3 0
13 5 0
3 5 0
8 8 1
12 5 1
9 12 1
14 12 1
7 19 2
4 8 2
3 10 2

13 12 0
7 7 0
0 13 0
6 8 0
10 15 1
9 19 1
8 19 1
18 7 1
10 5 2
18 11 2
7 19 2
