width 20
height 20
@...@@@@@@@@@@@@@@@@
@@.@@@@@@@@@@@@@@@@@
@...@@@@@@@@@@@@.@@@
.@.@.@..@@@@.@...@.@
.......@.@@....@@...
.@.@.@.....@.@@@@@@.
..@@@..@.@.@..@@@...
@..@@@.@@...@..@.@.@
@.@.@.@@@@.@@@.@....
.......@.@..@....@@@
.@@.@.@....@@.@.@@@@
@...@.@@.@..@..@@@@@
@@.@@@@@@.@...@@@@@@
@...@@@@..@.@...@@@@
.@.@.@.@.@.@.@@@.@.@
.............@......
@.@.@.@.@.@@...@.@@.
@@...@@.@@@..@..@.@@
@@@.@@@@.@.@..@.....
@@@@@@@@.....@..@.@.
11
18 8 0
13 16 0
12 17 0
12 3 0
5 9 1
9 13 1
16 14 1
10 14 1
14 19 2
7 10 2
8 19 2

13 10 0
13 12 0
10 6 0
16 7 0
13 13 1
8 4 1
0 9 1
19 16 1
2 3 2
3 17 2
3 11 2
