width 20
height 20
@@@@.@.@.@..@...@.@@
@@@@......@.@.@@...@
@@@.@.@.@.......@.@@
@@..@.@@..@.@.@.@..@
@@@..@..@..@@@@...@.
@@@.@.@.@.@.@...@...
@@....@......@@@@@.@
...@@.@.@.@.@.@.@.@.
@.@...@@@.@.........
...@.@.@.@@@.@@.@.@.
@.@@......@.@.@@.@..
...@.@@.@.........@.
@.@@@@@@.@.@.@@.@...
@@@@@@......@...@@.@
@@@@@@@.@.@@@@.@@@@@
@@@@@@...@@@@@.@@@@@
@@@@@@@.@@@@@@@@@@@@
@@@@@@@@@@@@@@@@@@@@
@@@@@@@@@@@@@@@@@@@@
@@@@@@@@@@@@@@@@@@@@
11
17 2 0
9 8 0
12 12 0
12 2 0
14 2 1
14 0 1
4 10 1
6 10 1
4 11 2
8 3 2
4 8 2

11 8 0
9 7 0
3 4 0
8 1 0
8 12 1
10 13 1
15 3 1
15 8 1
12 9 2
17 4 2
11 7 2
