width 20
height 20
@@....@.@@...@@@@@@@
@@@.@.....@@....@@@.
..@@.@@.@..@.@@.....
.@@@.....@@@@.@@@.@@
..@..@@.@.@@@.......
.@.@..@@......@.@.@.
.....@.@@@.@@@.@@@..
.@.@...@..@..@..@@@.
..@..@@.@.@.@@.@.@@.
.@@@................
.@.@@@.@.@@.@.@.@.@.
.....@@@@@@@@@@@.@@@
.@@.@.@.@@@.@.@.....
@........@..@...@.@.
..@.@.@.@.@...@@@@@@
.@.@@@......@....@@@
@@..@@@.@.@.@.@.@@@@
..@..@...@..@.@@@@@@
@.@.@.@.@@@.@@@@@@@@
........@@@.@@@@@@@@
11
3 6 0
7 17 0
0 19 0
16 12 0
4 6 1
18 6 1
7 16 1
6 15 1
10 13 2
9 8 2
16 8 2

16 8 0
11 17 0
4 19 0
6 7 0
15 7 1
13 13 1
3 6 1
11 10 1
10 0 2
5 1 2
17 13 2
