width 20
height 20
@@..@.@.@@.@.@@.@.@@
...@...............@
.@..@.@@@@.@.@.@.@@.
@.@..@@@@@@@@.@...@.
@...@.@@@@.@@.@@.@..
..@@@.@@@@.@@.@....@
@..@...@...@..@@.@..
..@.@.@.@.@.@.@.@.@.
@...@...............
@.@@.@.@.@.@.@.@.@.@
..@.....@@@...@.@@@@
.@.@.@.@@@@@.@@..@@.
......@@@@@@@..@.@..
.@.@.@.@@.@@.@...@@.
..@............@.@..
.@.@.@.@.@@.@.@@..@.
...@..@.@..@.@...@..
@.@@@.@..@.....@...@
...@@..@.@@@.@..@.@@
@.@@@@.....@..@.@..@
11
14 8 0
15 7 0
16 4 0
7 10 0
14 16 1
9 14 1
3 7 1
1 7 1
18 19 2
16 6 2
13 15 2

18 12 0
10 16 0
15 8 0
3 0 0
15 1 1
3 2 1
1 8 1
1 4 1
17 19 2
1 5 2
7 14 2
