width 20
height 20
....@@@@.@.@......@@
@.@.........@.@.@.@@
...@.@.@.@@.@..@...@
@.@.@.@@@....@@@.@..
.......@.@.@....@@.@
@@.@.@.@..@..@@.....
@@@...@.@.@@..@.@.@@
@@@@.@@...@.@.@@@@.@
@@@@@...@.......@@..
@@@@@@@.@@@.@.@..@.@
@.@@@@...@.@@@.@....
...@@@@.@..@.@...@.@
.@@@.@...@.....@..@@
.......@..@@@@..@...
@.@.@.@@.@.@..@.@.@@
...@@@...@...@.@.@.@
@.@@@.@.@@.@.......@
@.@@@...@...@@@.@@..
@@@@@@@.@@.@....@@@.
@@@@@.......@@.@@@@@
11
15 1 0
0 15 0
7 16 0
12 3 0
5 8 1
13 4 1
15 6 1
4 5 1
1 11 2
14 4 2
1 1 2

14 16 0
9 7 0
7 16 0
2 15 0
10 8 1
12 18 1
6 8 1
13 14 1
15 9 2
13 4 2
3 1 2
