width 20
height 20
@........@@@@@@@@@.@
.@.@.@@@.....@.@.@.@
....@..@@.@@@....@..
@.@..@...@...@.@...@
@.@.@..@@.@.@.@..@..
..@.@.@.@.......@@.@
@@........@.@.@.@@..
...@.@@.@.@@.@..@..@
@.@....@@@...@@@..@.
...@@.@@@@@@..@@@...
@.@.....@@.@.@@...@.
@@..@.@@.....@@.@.@@
@@@.@@@@@@.@@@...@..
.@....@....@@@@@..@.
...@.@.@@.@.@@...@..
@.@...........@@...@
@..@.@.@@.@.@...@.@.
..@@@.@.@@.@@.@@....
@.@@@.........@@@.@.
@@@@@@.@@.@.@..@...@
11
9 2 0
17 10 0
11 11 0
16 17 0
16 10 1
5 13 1
14 14 1
10 17 1
14 3 2
5 9 2
19 2 2

1 5 0
13 16 0
16 15 0
8 18 0
9 5 1
18 15 1
11 3 1
16 13 1
16 10 2
15 11 2
6 16 2
