width 20
height 20
@@.@..@.....@.@.@.@@
@...@..@.@@........@
.@.@.@..@...@.@@.@.@
.....@.@.@.@@.@.@@@@
.@.@.....@.@@@...@@@
.@.@.@.@.@.@@.@.@.@@
@@..@.@..@.........@
...@@..@...@@.@.@@@@
@.@@@.@@.@@@@..@@@@@
.@.@.....@@.@@@.@@@@
.....@.@.@....@.@@@.
.@.@..@@@@@.@...@@@.
..@.@.@@.....@@..@..
@.@..@@@.@@.@.@.@@@.
..@.@.@.@.@@@.@..@..
@.......@.......@.@.
@.@.@@@.@.@.@.@...@.
.@@@....@..@@@..@...
..@.@@.@@.@@@@.@..@.
@..........@@@..@@@.
11
1 16 0
6 10 0
13 13 0
15 17 0
10 6 1
2 9 1
14 15 1
0 3 1
2 6 2
2 15 2
16 12 2

4 15 0
3 13 0
0 11 0
13 10 0
14 17 1
0 12 1
3 6 1
13 3 1
19 12 2
8 13 2
4 2 2
