width 20
height 20
..@@@@@...@@@@@@@@@.
.@.@@@..@@.@.@@@....
...@..@......@.@.@@.
.@.@.@@@.@.@....@...
.@......@.@@.@.@.@.@
@.@@.@.@@..@@.......
......@@..@.@@.@@@.@
.@.@.@.@@.@...@.....
@.@.........@..@.@.@
...@.@.@@.@@.@....@@
@.@.@.@..@@....@@@.@
@.....@@....@@..@...
@.@.@.@.@.@.@..@.@.@
...@....@@.@.@......
@@@.@.@........@.@.@
@@@..@..@.@.@.@@@..@
@@.@.@@@.@..@@.@.@..
@....@.@.@@.@@.@...@
@@.@.........@.@.@..
....@.@.@.@.@.....@.
11
9 5 0
5 10 0
16 12 0
1 2 0
14 6 1
1 13 1
12 14 1
11 16 1
1 5 2
5 18 2
7 19 2

18 18 0
2 2 0
15 3 0
2 4 0
18 4 1
5 12 1
10 18 1
12 10 1
5 6 2
14 14 2
8 0 2
