width 20
height 20
@..@.@.@.@@@@@@@@@@@
@@.@......@@@@@@@@@@
@....@.@.@.@@@@@@@@@
@@.@..@.....@@.@@@@@
@.@.@@@@@@@..@.@@@@@
....@.@@.@@.@...@@@@
@.@...........@...@@
...@.@.@@@.@.@@.@...
@.@.@@@@..@.@@.@.@.@
......@..@..@.......
.@@.@@@@.@.@.@@.@.@.
@............@..@@..
.@.@.@@@.@.@..@.@@@@
....@@@.@@.@.@.@.@.@
.@.@@@.....@........
..@@@@@.@.@.@@@.@@.@
.@@@@@@..@...@.@....
@@@@@@@.@@@.@@.@@.@@
@@@@@@@..@...@......
@@@@@@@.@@@@...@.@.@
11
5 6 0
17 10 0
12 19 0
18 8 0
16 9 1
11 3 1
7 16 1
10 12 1
15 18 2
16 14 2
8 11 2

11 15 0
12 16 0
16 16 0
3 8 0
19 9 1
8 2 1
10 3 1
15 18 1
8 5 2
16 14 2
6 0 2
