width 20
height 20
@@@@@@@@@@@@@@@@@@.@
@@@@@@@@@@@@@@@@@...
@@@@@@@@@@@@@@@@.@.@
@@@@@@@@@@@@@@@.....
@@@@@@@@@@@@@@.@.@.@
@@@@@@@@@@.@@..@..@@
@@@@@@@@@....@...@.@
@@@@@@@@@@.@.@.@....
@@@@@@@@@@@..@@..@@@
@@@@@@@@@@..@.@@....
@@@@@@@@@..@...@.@@.
@@@@@@.@..@.@@.@@...
@@@@@...@.........@.
@@@@@.@.@.@.@.@.@.@.
@@@@...@@..@@@@@.@.@
@@@.@.@.@.@.@.@@....
@@@.......@...@.@.@.
@@@.@.@.@...@......@
@....@@@@@.@..@.@.@@
..@.@@@@@@@..@..@@@@
11
17 13 0
14 12 0
16 15 0
12 12 0
5 17 1
10 17 1
4 18 1
8 16 1
16 9 2
6 12 2
13 12 2

12 16 0
16 14 0
11 8 0
9 11 0
5 17 1
17 9 1
10 6 1
9 16 1
10 9 2
16 6 2
16 17 2
