width 20
height 20
..@..@@@@@@@@.@@@@@.
.@..@@@@@@@@...@@@..
.@.@.@@@@@@.@@..@.@.
......@@.@...@.@....
@@.@.@....@.@...@.@@
@@@....@.@....@.....
@@.@.@.@.@@.@..@@.@@
@@...@.@..@@.@.@.@@.
@@@@.@..@@..........
@@@@@..@.@.@@.@.@.@.
@@@@@@...@@.@@.@@@..
@@@@@@.@@.......@.@.
@@@@@@....@.@@@.....
@@@@@@@.@.@@....@.@.
@@@@@@@@...@@.@.@@.@
@@@@@@@@@.@@..@@.@.@
@@@@@@@@..@..@@@....
@@@@@@@@@..@.....@@.
@@@@@@@@@.@@.@.@.@@.
@@@@@@@....@@...@...
11
9 14 0
19 12 0
13 13 0
10 5 0
7 4 1
9 16 1
13 8 1
3 1 1
4 4 2
14 13 2
8 3 2

0 2 0
14 6 0
19 10 0
12 13 0
9 18 1
14 4 1
13 8 1
13 6 1
17 5 2
16 17 2
11 12 2
