width 20
height 20
@@@@@@@...@@@@@.....
@@@@@@@.@@.@.@.@@.@@
@@@@@@...@..........
@@@@@@@.@@.@.@@@.@.@
@@@@@@....@.@..@@...
@@.@@..@.@@..@.@..@@
.@..@@..@@@@.....@.@
...@.@.@.@...@.@.@..
@@.....@...@.@@.@@@.
.@.@.@@..@..@.......
...@.@.@..@@.@@.@@.@
.@@......@.......@..
@@@@.@.@.@@.@@.@.@.@
......@@@...@@@...@@
.@.@.@...@@.@@.@.@.@
.@@@@@@@..@@.@......
...@.@.@@......@.@.@
.@........@.@@@@@...
@@@@.@.@.@.@@..@.@.@
......@......@.....@
11
8 18 0
18 2 0
11 4 0
17 1 0
10 8 1
16 7 1
2 14 1
6 5 1
0 10 2
4 18 2
4 17 2

15 0 0
5 19 0
8 8 0
8 9 0
8 17 1
12 1 1
13 16 1
2 16 1
15 10 2
18 2 2
14 6 2
