width 20
height 20
............@@@@.@.@
@@.@.@.@@.@.@.@....@
..@@@@.@@@......@@.@
.@.@.@@.@..@.@.@.@.@
......@.@@..@@@.....
@@.@@....@.@@@..@.@.
.@.@.@@.@@@@..@..@..
.....@@@.@@.@.@.@@.@
.@.@..@...........@.
..@..@@@.@@.@@.@@...
.@@@..@@..@..@@.@.@.
.@@..@.@@@.@.@...@..
@@.@.@...@.@@@@@...@
.....@.@....@@@@.@.@
@.@@@.@.@@.@.@@@@...
...............@..@.
.@@.@.@.@.@@@.@.@@@.
.@@@@..@..@.........
@@@@..@@@.@.@.@.@.@.
@@@@@..@@@...@...@..
11
19 17 0
6 11 0
17 18 0
16 12 0
15 8 1
0 10 1
11 1 1
14 3 1
11 0 2
1 14 2
15 17 2

19 17 0
10 3 0
2 4 0
4 9 0
3 4 1
19 11 1
15 17 1
18 17 1
9 15 2
13 6 2
4 18 2
