width 20
height 20
@..@@@@@@.@@.@@@@@@@
.@..@@.@.....@@@@@.@
...@.@.@.@.@@@@@@...
.@.......@.@@@.@@.@.
@..@.@.@@.@.@...@.@.
.@@...@@@.....@@.@..
.@@@@.....@@.@@@..@.
.....@.@@...@.@.@.@.
.@.@..@@@.@.........
@..@.@@@@@.@.@.@@.@@
.@..@..@...@@..@...@
...@@.@@@.@.@@..@@@.
.@.@...@..@....@.@..
..@.@.@@@...@@.@...@
@.........@@..@@.@@.
.@.@.@.@.@...@......
.@..@@@.@.@@..@.@.@.
.@.@@.@...@@@....@..
......@@.@.@..@.@.@.
.@@.@........@....@.
11
13 10 0
8 6 0
17 19 0
9 19 0
12 15 1
12 1 1
17 9 1
1 7 1
14 4 2
8 12 2
15 15 2

14 9 0
9 13 0
19 8 0
13 7 0
7 17 1
11 19 1
17 6 1
6 14 1
10 5 2
2 7 2
14 8 2
