width 20
height 20
@@..@....@@@@.@@....
@..@..@.@.@......@@.
.@..@@......@.@.@...
...@.@@.@.@..@.@@@.@
.@@......@@@.@.@....
..@.@@.@..@@@..@@.@.
@.....@..@...@...@@@
..@.@..@@@@@...@.@@@
@.@..@@@@@...@.@..@@
@@..@@.@@@.@@...@.@@
@@@....@@..@.@@.@..@
@.@.@.@.@@...@.@.@.@
.....@@..@.@.....@@@
@.@.@.@.@.@.@.@@..@@
..@..........@@..@.@
.@..@@@.@.@.@@.@....
@.@@@..@@@...@...@.@
..@.@.@@.@@@..@.@...
@............@.@.@.@
@@@.@.@.@@.@........
11
8 2 0
7 12 0
8 12 0
3 2 0
12 12 1
17 10 1
7 14 1
9 1 1
11 14 2
3 19 2
6 5 2

14 11 0
1 8 0
12 17 0
19 5 0
5 4 1
2 9 1
6 4 1
16 11 1
3 18 2
0 2 2
12 7 2
