width 20
height 20
@@.@@@@@@@@@@@@@@@@@
....@@@@@@@@@@@@@@@@
@@.@.@@.@@@@@@@@@@@@
.........@@@@@@@@@@@
@.@.@@.@@@@@@@@@@@@@
@..@@..@@@@@@@@@@@@@
@@.@..@@@@@@@@@@@@@@
@.@.@..@@@@@@@@@@@@@
......@@@.@@@@@@@@@@
@.@.@@@@...@@@@@@@@@
@@...@@..@@@@@@@@@@@
@@@.@.@@..@@@@@@@@@@
@@.....@.@@@@@@@@@@@
@.@.@@.....@@@@@@@@@
...@...@.@.@@@@@@@@@
.@...@..@...@@@@@@@@
@..@.@@@.@.@.@@.@@.@
@@..@@@@............
@..@@@@@@.@.@.@@.@@.
..@@@@@@@..@@@@@@@@@
11
1 5 0
1 19 0
1 8 0
8 11 0
4 16 1
16 17 1
5 5 1
5 8 1
0 3 2
2 10 2
14 17 2

5 8 0
2 3 0
1 19 0
4 2 0
3 4 1
6 12 1
9 11 1
5 11 1
3 7 2
19 18 2
8 11 2
