width 20
height 20
..@..@..@.....@@..@.
.@@@...@.@@@@.@.@...
..@@.@............@@
.@.@@.@@.@.@.@@.@...
........@.@.@.@@.@.@
@@.@@@@.............
@...@@@@.@.@.@@.@@.@
.@@.@.@.@.@.@@.@....
...............@@.@.
@.@.@.@.@.@.@.@@@@@.
@..@@@...@.@...@@@..
..@@@@@.@...@@....@@
@.@@@@@@..@.@..@.@..
...@@@@..@@.@@.@...@
@@.....@..@.@@@@@@..
.@.@.@.@.@.@.@.@.@.@
..@..@@............@
.@.@.@..@.@.@.@.@.@@
......@..@@@@..@@.@@
.@.@.@@.@@@@@.@....@
11
8 2 0
0 1 0
5 9 0
4 16 0
16 16 1
1 2 1
9 0 1
13 8 1
9 4 2
2 8 2
7 19 2

18 15 0
11 13 0
11 0 0
1 4 0
11 8 1
18 6 1
0 4 1
3 9 1
10 11 2
19 12 2
7 17 2
