width 20
height 20
@@@@@@@@@@@@@@@@@@@@
@@@@@@@@@@@@@@@@@@@@
@@@@@@@@@@@@@@@@@@@@
@@@@@@@@@@@@@@@@@@@@
@@@@@@@@@@@@@@@@@@@@
@@@@@@@@@@@@@@@@@@@@
@@@@@@@@@@@@@@@@@@@@
@@@@@@@@@@@@@@@@@@@@
@@@@@@@@@@@@@@@@@@@@
.@@@@@@@@@@@.@@@@@@@
..@@@@@@@@@...@@@@@@
.@.@@@.@.@.@.@.@.@@@
.....@.......@.@..@@
.@@.@.@@.@@.@....@.@
@..........@.@.@....
..@@.@.@.@...@@.@@@.
.@..@.@.@@@@........
.@@...@..@...@.@@.@.
@...@@.@.@@.@@...@@.
..@..........@.@@...
11
6 11 0
19 15 0
16 14 0
5 13 0
19 17 1
11 12 1
10 19 1
0 15 1
6 12 2
12 15 2
16 12 2

18 14 0
3 14 0
0 9 0
3 17 0
8 12 1
10 19 1
2 18 1
6 15 1
15 16 2
1 14 2
17 14 2
