width 20
height 20
@.@.@.@@@..@@..@@@..
.......@..@@@@..@..@
@.@@.@..@..@@@.@..@@
@@@.@@.@.@.@.@.@.@..
@.@................@
....@.@.@@.@@.@.@.@@
@.@.@@@@..@@...@....
@..@.@..@....@@@.@@@
@@...@.@..@@@@@@@...
@.@.@@..@..@.@.@.@@.
...@@.@...@.........
.@......@..@.@.@.@@.
@..@.@.@.@@.@@@.@...
@@..@@@...........@.
@@.@@@..@.@@.@.@@..@
@@..@.@..@....@@@@.@
@.@...@@@@.@.@@@@@..
@..@@.@.@...@@@@@@@@
@@........@..@@@@@@@
@..@.@.@@@@.@@@@@@@@
11
16 2 0
18 10 0
17 13 0
9 7 0
9 1 1
6 18 1
13 13 1
12 9 1
1 12 2
2 11 2
9 10 2

15 4 0
9 10 0
12 4 0
8 13 0
7 15 1
12 9 1
7 9 1
12 7 1
5 10 2
10 13 2
18 16 2
