width 20
height 20
......@@....@...@...
@@@.@@@@.@.@.@.@.@.@
@@....@.@........@..
@.@.@.....@.@@.@..@.
.....@.@.@.@..@..@..
@.@@..@@@@.@.@.@.@.@
....@@.@.@.........@
@.@.@....@@@.@.@.@..
@..@.@.@.@....@@@..@
@@......@@.@.@@@@@.@
@@@.@@.@....@@@@@@..
@@....@.@@.@@@@@@@@@
@.@@@...@.@@@@@@@@@@
......@@...@@@@@@@@@
@.@.@.@@.@@.@@@@@@@@
@@...@......@@@@@@@@
@.@.@.@@.@.@@@@@@@@@
..........@@@@@@@@@@
@@@.@@.@.@@@@@@@@@@@
@@@@@@@...@@@@@@@@@@
11
1 3 0
8 6 0
2 9 0
1 5 0
14 3 1
0 0 1
16 2 1
16 7 1
14 6 2
3 10 2
18 10 2

1 3 0
1 8 0
4 11 0
7 17 0
10 13 1
14 3 1
10 2 1
6 9 1
8 13 2
18 4 2
7 9 2
