width 20
height 20
@@@@@@..@@..@..@..@@
@.@.@.@.@..@@@..@.@@
....@....@..@.@....@
@.@.@.@@@..@@...@.@@
@..@..@.@.@..@@..@@@
..@.@.....@.@.@.@.@@
@...@@@.@..........@
.@@..@@@..@@.@.@@.@@
..@.@.@.@..@@...@...
.@.......@.@@@.@.@@@
.@@@.@.@....@.......
....@.@..@.@@@.@.@.@
@.@.@.@.@.@@@..@@...
...@....@.@@@@...@.@
@.@.@.@......@@@.@@@
..@....@@.@@@@.@...@
@.@@@.@@.@@@@....@..
..........@.@.@.@..@
@@.@.@.@@....@@@@@@@
....@@@...@.@@@@@@@@
11
14 8 0
10 8 0
3 1 0
1 14 0
17 15 1
1 13 1
16 4 1
1 3 1
13 8 2
16 6 2
3 2 2

0 8 0
18 10 0
3 5 0
1 17 0
12 7 1
16 0 1
3 19 1
3 6 1
4 17 2
10 9 2
6 9 2
