width 20
height 20
@@@......@@@.....@@@
@@.@.@.@..@..@@.@@@@
@@....@@.@.@..@....@
@.@.@.@@...@.@.@.@@@
..@@.@.@.@@@...@@@@@
@.........@.@@.@.@@@
@@.@.@@.@.........@@
@@@@.@.@@.@.@.@.@@@@
@..@.@..@@@@.@....@@
..@.@.@.@.@@..@.@@.@
@.@..........@@.....
....@.@.@.@@....@.@@
@.@..@.@.@..@@.@....
...@......@.@.@@@.@.
.@@..@.@.@@.@...@@..
@.@.@.@.....@@@.@.@@
...@@.@@@.@.........
@.@.@....@@.@.@.@.@.
.....@@.@.@..@...@..
@@.@........@@@@@@@.
11
5 0 0
5 10 0
13 6 0
4 18 0
12 8 1
1 4 1
5 5 1
4 2 1
11 12 2
2 8 2
11 1 2

3 14 0
1 15 0
10 15 0
8 17 0
14 0 1
7 18 1
13 14 1
5 5 1
11 19 2
7 13 2
11 15 2
