width 20
height 20
@@@..@@@....@.@@.@@@
@@..@@@..@.@.....@@.
@@@..@@.@.@.@.@@....
@@..@.@.........@@.@
.@@.....@.@@.@.@@.@@
...@@.@.@..@.@.@..@@
.@@..@@@@.@.@.@.@...
.@.@..@@..........@@
....@....@.@@.@.@...
@.@..@.@..@.@..@@.@.
.@..@@@@.@....@@@@..
..@..@@@@@@.@...@@.@
.@..@.@.@...@@.@@...
...@@.....@...@..@@.
@@....@.@.@@.@.@....
@.@.@.@@....@....@.@
....@@.@@.@..@.@..@@
.@@.....@@..@...@@.@
..@.@.@.@@@@.@.@....
.@@@..@@@@@@.....@@.
11
14 9 0
11 13 0
6 16 0
12 3 0
7 17 1
5 18 1
3 18 1
13 6 1
9 15 2
1 13 2
7 5 2

12 13 0
16 18 0
8 9 0
15 13 0
14 4 1
5 18 1
17 18 1
0 7 1
13 6 2
11 6 2
5 3 2
