width 20
height 20
...@....@......@@@@@
@.@.@.@.@@.@.@.@@@@@
.......@..@@@..@@@@@
@@.@@.@@.@@@.@.@@@@@
@@@......@@@...@@@@@
.@.@.@.@..@..@@@@@@@
.....@@@@@..@..@@@@@
.@@@.@@@@@@..@...@@@
....@.@..@.@...@@@@@
@.@....@.....@@..@@@
@.@.@.@@@.@@..@.@.@@
..@@.@@@@.@..@....@@
.@@@.@.@.@.@.@@.@.@@
...............@...@
@.@.@.@.@.@.@.@.@.@@
...@...@...@.......@
@.@@@.@.@.@.@.@.@@..
@..@@@..@...@.@.@..@
..@@@@@...@.@..@.@..
@..@@@@@.@..@@@....@
11
12 11 0
8 18 0
14 13 0
13 10 0
4 4 1
9 0 1
0 5 1
10 6 1
5 13 2
8 13 2
14 2 2

0 0 0
13 13 0
12 1 0
1 0 0
1 6 1
2 15 1
1 19 1
2 19 1
9 11 2
5 8 2
1 8 2
