width 20
height 20
@@@@...@..@.@.@..@..
@.@.@.@.@.@.@.@.@@@.
.................@..
.@.@.@.@@.@@.@.@...@
..@..@@@@@..@.@@@@.@
.@..@..@@@@....@....
..@.@.@..@@@.@..@.@.
@.@...@@.@.@.@.@.@..
...@@........@.@..@.
@.@@@.@.@.@.@@@.@...
...@...@@@...@....@.
@.@@@.@@@@@.@@@.@@.@
@@@@@..@@@@..@......
@@@...@..@.@@.@.@.@.
..@.@..@.......@@.@.
.@@.@.@@@@.@@.@@.@..
.@.@.@.@.@.@......@.
............@@.@@.@.
@@@.@.@.@.@@@@@.@...
@@...@...@@@@@....@.
11
12 16 0
3 17 0
9 2 0
6 19 0
13 0 1
13 1 1
14 19 1
14 8 1
5 5 2
11 8 2
18 15 2

19 5 0
18 11 0
10 16 0
11 8 0
7 2 1
15 0 1
15 12 1
19 12 1
15 19 2
10 14 2
14 5 2
