width 20
height 20
...........@@@.@....
@.@.@.@@.@.@@...@.@@
.@@@...@@...@@@...@.
..@@@.@..@@..@..@@..
@..@..@@....@.@.@@@.
..@.@.@.@.@......@..
@.....@....@@.@.@.@.
@@.@.@..@.@.@.@.....
....@.@@@....@..@@.@
@@@.@.@.@.@.@@@...@.
@@..@...@@.@.@.@@@..
@@@.@.@....@.@.@.@.@
@@....@@.@.........@
@.@@@@@...@@@@.@.@..
@.@@.@@@.@.@.@@@@..@
......@..........@..
@@@.@..@@.@.@@@.@..@
@@@@..@@@.@.@..@.@.@
@@.@.@.@@@.@.@......
@..............@.@.@
11
8 19 0
12 11 0
1 6 0
9 7 0
13 5 1
14 11 1
17 2 1
10 10 1
4 7 2
12 18 2
2 4 2

10 1 0
0 0 0
1 0 0
11 3 0
5 5 1
16 12 1
1 19 1
7 10 1
1 13 2
10 12 2
5 16 2
