width 20
height 20
@@@.@.@.@.@..@@.@.@.
@@..........@.......
@@@.@@@.@.@...@.@.@@
@@@@@@...@..@.@.@...
@@@@@@@.@.@.@@@@.@.@
@@@@@@....@@@.@...@@
@@@@@@@.@......@.@..
@@@@@@...@.@@.@....@
@@@@@@@.@@.@..@.@@..
.@@@@@.@@.@.@.@@.@.@
..@@@...............
.@.@.@.@.@.@.@.@.@@.
........@@@@..@....@
.@.@.@.@@@@.@@.@.@@@
..@@@...@@.....@.@@@
.@.@..@...@.@@.@@@@@
...@@..@.@....@.@@.@
.@..@.@@@.@@@.......
@@.@.@.@......@.@.@@
.........@@.@@...@@@
11
9 15 0
2 16 0
15 2 0
14 10 0
9 0 1
16 9 1
8 11 1
18 4 1
12 6 2
15 18 2
4 1 2

3 12 0
19 1 0
7 12 0
9 5 0
4 19 1
15 19 1
12 10 1
1 19 1
14 17 2
16 17 2
2 17 2
