width 20
height 20
..@...@..@@@@@@@@@@@
.@@@.@.@..@@@@@@@@@@
..@......@.@...@@@@@
.@.@.@@.@...@.@.@.@@
.@.@.@@.@@.@.......@
.......@@@...@@.@.@@
.@.@@.@.@.@@.@.@.@@@
..@@.............@@@
.@...@.@.@.@.@.@..@@
@..@.@@...@...@.@..@
@@..@..@.@@@.@....@@
...@..@.@.@.@.@.@..@
@@.@.@.........@@@..
@.....@.@.@.@.@.@.@.
@@.@.@.@.@@@........
.@@......@@@@.@.@.@.
..@.@.@.@@@@@@.@@@@.
.@.@.@@.@@@@@.......
........@@@@@@.@@.@.
.@.@@@.@@@@@@...@..@
11
9 3 0
17 17 0
18 14 0
7 11 0
10 5 1
3 13 1
14 14 1
0 4 1
11 3 2
10 12 2
1 18 2

13 4 0
2 4 0
4 7 0
7 16 0
7 7 1
9 13 1
0 17 1
7 4 1
6 5 2
0 19 2
2 17 2
