width 20
height 20
..@.......@...@..@.@
@.@.@.@.@@@@.@.@....
....@@@.@@@......@@@
.@.@........@@.@...@
..@..@@.@.@.@.@..@..
.@.@@@...@@@@.@.@@@@
.....@@.@.@......@.@
@@.@@@@@...@.@.@....
...@@.@@@@.@..@@.@.@
@.@@...@@@...@@@@..@
..@.@.@@@@@@@@@@.@..
@......@.@.@@@@....@
..@@.@......@@..@@..
@@..@..@@.@.@@@..@.@
@@.@.@@@@@...@@.@.@@
@.....@.@.@.@@.....@
..@@.@........@.@.@.
@.@....@.@@.@..@....
...@@.@.@.@.@.@@@.@.
@.@........@..@@@@..
11
17 14 0
9 3 0
6 11 0
4 0 0
11 15 1
3 19 1
0 12 1
10 9 1
3 0 2
15 0 2
17 1 2

10 8 0
19 7 0
6 11 0
10 19 0
19 1 1
13 17 1
17 15 1
4 0 1
9 3 2
16 3 2
18 1 2
