width 20
height 20
@.@@.@..@@.@@@.@.@.@
..@...@.............
@.@.@..@.@.@.@.@.@.@
.....@....@@@...@...
@@@.@.@.@..@.@.@.@.@
.@..@..@@.@...@....@
.@@...@@.@@@.@.@.@..
.@.@.@@..........@.@
.....@@@.@.@.@.@..@.
@@@.@.@.@.@...@.@...
...........@.@....@.
@@.@@.@.@.@.@@.@.@@@
@.@@@@@@......@.@.@.
..@@@.@.@.@.@.......
@..@.......@@@.@.@@.
..@.@@@.@.@.@@@@@...
.@.......@..@@@@.@.@
...@.@@.@@.@@@......
@@..@.......@..@.@@.
...@@@@@.@@..@..@@@.
11
14 6 0
12 6 0
2 14 0
19 14 0
5 5 1
8 3 1
5 4 1
17 1 1
3 1 2
0 15 2
12 9 2

11 7 0
2 17 0
6 0 0
7 4 0
7 13 1
14 18 1
10 4 1
17 1 1
15 19 2
18 7 2
16 4 2
