width 20
height 20
@@@@@@@...@...@@.@..
@@@@@@.@.@@.@@@...@.
@@@@@@.........@@...
@@@@@@@@.@.@@.@@.@@.
@@@@@@@.@.@@........
@@@.@.@.@.@.@.@.@.@@
.............@.@....
@.@@.@.@.@.@.....@@@
....@@..@@@.@.@@.@.@
.@@..@.@@@@..@@@@...
@...@..@@@..@.@@.@.@
@@.@.@..@.@...@.....
@@@....@...@@..@.@.@
@@.@.@..@.@..@....@@
@@....@.@...@..@@@@@
@@.@.@.@.@@...@@.@..
....@.....@.@..@..@.
.@.@..@.@.@@..@.@...
.@@.@.@@....@...@.@@
........@.@...@.....
11
7 2 0
16 0 0
12 7 0
2 14 0
11 18 1
19 11 1
16 12 1
16 15 1
0 9 2
17 18 2
5 16 2

17 19 0
13 16 0
9 2 0
13 15 0
5 18 1
8 12 1
0 16 1
16 16 1
0 9 2
6 2 2
1 8 2
