width 20
height 20
@@@@.......@.@...@@@
@@@..@.@.@@....@.@@@
@@.@..@@@@@.@@..@@@@
@....@.@.@.@..@..@@@
@@.@.........@.@.@.@
@@@..@@@.@.@.....@.@
@@@@.@....@@@@.@.@.@
@@@@@@@.@.@@@..@....
@@.@@@@@...@..@..@.@
@..@@@@@@.@.@@.@@...
.@..@@@@.......@@@.@
.@.@@@@@@.@@@@..@@@@
....@@@...@.@@.@@...
@@.@.@..@.@.......@@
@.....@..@..@.@.@@..
.@.@.@@@.@@.@@.....@
....@.@.@.@..@@.@.@@
@.@.........@..@...@
.@.@.@.@.@@@.@.@@.@@
.....@@........@...@
11
8 6 0
10 10 0
7 0 0
10 4 0
19 12 1
12 13 1
9 12 1
6 18 1
14 12 2
11 13 2
11 14 2

9 13 0
10 10 0
7 16 0
10 4 0
16 1 1
2 12 1
6 1 1
9 10 1
16 8 2
2 10 2
2 19 2
