width 20
height 20
.@......@.@..@...@@.
...@.@@.....@.@.@...
@.@@.@@@.@@.......@@
.@......@..@@.@.@.@.
...@.@.@@.@@.@.@....
.@.@..@@..@....@.@@.
.@@.@.@.@...@@@.@@@.
.....@....@@........
.@.@..@.@@@@@.@.@@.@
..@@.@.....@...@..@.
.@.@.@.@@.@.@.@.@...
@........@........@.
@.@@.@.@@@.@@.@.@.@.
...@@.@@..@@.@.@.@..
@@..@.@.@.........@.
...@......@.@.@.@...
.@.@@.@@.@@..@@@..@.
..@.....@@..@.@..@@.
.@..@.@@@..@@...@.@.
@@@.@..@@@.@..@@....
11
16 19 0
6 9 0
12 0 0
2 18 0
16 14 1
7 15 1
11 2 1
3 14 1
6 17 2
14 9 2
5 15 2

14 5 0
6 10 0
15 10 0
13 19 0
0 17 1
1 2 1
14 4 1
2 10 1
0 5 2
11 15 2
0 16 2
