width 20
height 20
.......@...@...@@@@@
@@.@@@@..@@@@.@..@@.
.......@.......@.@..
.@@@.@@@@.@.@@....@.
@.@........@@.@@.@@.
....@.@.@.@....@....
.@@..@..@.@.@@.@@.@.
..@.@@@@.@.@.@.@@@@.
@@.....@........@@..
@@@.@.@..@.@.@@....@
@@@@.@.@..@@@@@@.@.@
@@@@.....@.@.@..@@..
@@@@.@@@@......@.@.@
@@@@.@.@..@@.@.@....
.@......@.@@@...@@.@
.@.@.@.@.....@@..@@@
..@...@@@.@.@...@@@@
.@.@.@.@.@@..@.@@@@@
.@...@.....@..@@@@@@
...@...@.@...@@@@@@@
11
12 19 0
10 11 0
9 0 0
16 15 0
2 19 1
13 12 1
10 19 1
14 3 1
16 3 2
11 5 2
8 10 2

10 9 0
14 6 0
9 3 0
9 13 0
9 12 1
4 13 1
16 15 1
7 9 1
14 16 2
12 18 2
8 13 2
