width 20
height 20
@..@.@@@.@.@.@.@.@.@
..@.................
@.@@@.@.@.@@@.@.@@@.
...@...@@@....@@.@..
@@.@.@.@@@@.@.@@..@.
@...@@@.@.@..@@@@...
@@.@....@...@..@..@@
@...@.@.@@@.@.@.@.@.
@@@.@@....@@........
@....@@.@....@.@.@@@
.@.@...@..@.@.@@...@
..@.@.@@.@.@.....@.@
@......@....@.@.@@@@
@.@@.@@@@.@..@@@@@@@
....@@.@.@..@@@@@@@@
@@.@.......@@@@@@@@@
.....@.@.@..@@@@@@@@
@@.@..@...@...@@@@@@
@...@.@@@.@@@@@@@@@@
@@.@@...@@@@@@@@@@@@
11
4 9 0
9 9 0
13 11 0
10 9 0
2 10 1
5 15 1
1 9 1
16 11 1
5 1 2
1 11 2
13 10 2

18 11 0
10 3 0
3 9 0
6 6 0
16 10 1
13 3 1
18 3 1
2 12 1
18 0 2
0 14 2
12 1 2
