width 20
height 20
@@.@.@@@@@@.@.@.@..@
@.....@@@@........@@
@@.@.@.@@@@@@.@.@@@@
@@@.....@@@...@@@@@@
@@.@.@.@.@.@.@.@.@.@
@...@...............
..@...@.@.@.@.@.@@.@
.@..@@...@..@@@.@..@
@.@..@@.@.@..@..@@@@
....@.@@....@@@@@@@@
.@@....@.@@..@..@@@@
..@@.@.@...@@@.@@@@@
.@.@@@.@.@@.@..@@@@@
......@......@.@@@@@
.@.@.@@@.@.@...@@@@@
@@@..@..@.@@@.@.@.@@
@@@@..@............@
@@@@.@@@.@@.@.@.@@..
@@@@..@...@@.@@@.@.@
@@@..@..@@.........@
11
14 1 0
9 9 0
18 19 0
15 1 0
17 0 1
8 9 1
5 10 1
14 13 1
15 16 2
14 19 2
11 19 2

4 18 0
7 13 0
4 19 0
10 19 0
15 2 1
0 11 1
4 10 1
0 13 1
14 13 2
11 10 2
12 19 2
