width 20
height 20
@@@.@@.@....@..@@...
@....@.@@.@...@.@.@.
..@.@..@...@@....@..
.@....@@@@.@..@.@@.@
..@@@..@.@@.@.@....@
.@@...@@....@.@@.@..
@@@@@....@@....@@..@
@@@.@.@.@.@@@.@@@@..
.@.....@.......@@..@
..@.@.@..@.@.@.@..@@
.@..@.@@..@.@.@.@.@@
.@.@.@.@.@......@..@
.......@@.@.@.@.@.@@
.@.@@@....@..@.@.@@@
..@@@@.@@.@@......@@
.@.@@@@....@.@.@.@@@
....@@@@.@..@@@...@@
.@.@@.....@@.@@@.@@@
@@@@@@.@@........@.@
@@@@@....@.@.@.@....
11
7 17 0
17 19 0
5 19 0
0 13 0
13 18 1
19 0 1
1 1 1
11 5 1
8 10 2
15 1 2
5 12 2

10 8 0
16 15 0
7 13 0
9 2 0
10 18 1
18 11 1
8 2 1
18 19 1
18 3 2
9 10 2
3 10 2
